XXXXXXXXX
Xp XXXXXX
X  XXXXXX
XX X  XXX
Xp X  XXX
X  D   XX
Xp     XX
XXXXXXXXX
XXXXXXXXX