XXXXXXXXXXXX
XXXXXXXXXXXX
XXXXXXXXXXXX
XXX   XXXXXX
XXX p XXXXXX
XXXX XXXXXXX
XX   XXXXXXX
XX    XXXXXX
XXX   XXXXXX
XXX   XXXXXX
XXXXXXXXXXXX
XXXXXXXXXXXX