XXXXXXXXXXXXXXXXXXXXXXX
XXXXXXXXXXXXXXXXXXXXXXX
XXXXXXXXXXXXXXXXXXXXXXX
XXXXXXXXXXXXXXXXXXXXXXX
X  XXXXXXXXXXXXXXXXXXXX
X XXXXXXXXXXXXXXXXXXXXX
X XXXXXXXXXXXXXXXXXXXXX
XXXX  XXXXXXXXXXXXX  XX
XXXX   XXXXXXXXXXXX  XX
XXXX X   XXXXXXXXX  XXX
XXX  XXX X XXXXXXXX  XX
XXX XXXX X XXX XXXXX XX
XXX XXX  X  XXpXXXXX XX
XXX X      XXX XXXXX  X
XXX XX X       XXXXXX  
X   XX  XXXXX  XXXXXX  
XXXXXXX   XXX XX XXXXXX
XXXXXXXXX XXX XX  XXXXX
XXXXXXXXX      XDXXXXXX
XXXXXXXX  pDX    XXXXXX
XXXXXXXX         XXXXXX
XXXXXXXX         XXXXXX
XXXXXXXX X      DXXXXXX