XXXXXXXXXXXXX
XXXXXXXXXXXXX
XXXXXXXXXXXXX
XXXXXXXXXXXXX
XXXXXXXXXXXXX
X  XXXXXXXXXX
X          XX
XX   X  XXDXX
XX   X  X  XX
XX   XX    XX
XXXXXXXXX  XX
XXXXXXXXXXXXX
XXXXXXXXXXXXX