XXXXXXXXXXXXXXXXXXXXX
X pXX  XXXX      XXXX
XX  X   XXXXX  D XXXX
XXX X X XXXX     XXXX
XD  X X    X       XX
XX     DD  XpD X   XX
XXX  p  X   DX X X XX
XXXXX X      XXX    X
XXXX    XXX   XXX   X
XXXXXX  XXXXX XXX  XX
XX       XXXX XX  XXX
XX XXXXXD  XX XX   XX
XXXXXXXX   XX XXX  XX
XXXXXXXX XXXXXXX   XX
 XXXXXXXXXXXXXXXXXXXX
XXXXXXXXXXXXXXXXXXXXX
XXXXXXXXXXXXXXXXXXXXX
XXXXXXXXXXXXXXXXXXXXX
XXXXXXXXXXXXXXXXXXXXX
XXXXXXXXXXXXXXXXXXXXX
XXXXXXXXXXXXXXXXXXXXX