XXXXXXXXX
X  XXXXXX
X   XXXXX
X   X  XX
Xpp X  XX
XX    XXX
XXXXXXXXX
XXXXXXXXX
XXXXXXXXX