XXXXXXXXXXXXXXXXX
XXXXXXXXXXXXXXXXX
XXXXXXXXXXXXXXXXX
XXXXXXXXXXXXXXXXX
XXXXXXXXXXXXXXXXX
XXXXXX  XXXXXXXXX
XXXXXXX XXXXXXXXX
XXXXXXX XXXXXXXXX
XXXX XX   X  XXXX
X    XXXX XX XXXX
X XXXXXXX    XXXX
XX X XXXX  XXXXXX
X  X XXXX XXXXXXX
X XX  XXX  XXXXXX
X      XX  XXXXXX
XX    XX   XXXXXX
XX    XX    XXXXX