XXXXXXXXXXXXXXXXX
X   XXXXXXXXXXXXX
X         XXXXXXX
XX XXXXX    XXXXX
X   XXXXp   XXXXX
X    XXX   X   XX
X    XXX       XX
XX    XXXX     XX
XX    XXXXXX   XX
XX   X  XXXX   XX
XXX     XXXX   XX
XXX     X  X   XX
XXXX       XXXXXX
XX      D  XXXXXX
XX     XXXXXXXXXX
XXXXXXXXXXXXXXXXX
XXXXXXXXXXXXXXXXX