XXXXXXXXXXXX
X   XXXXXXXX
X   XXXXXXXX
XX XXXXXXXXX
X   XXXXXXXX
X   XXXXXXXX
X     XXXXXX
X        XXX
X    p   XXX
X     XXXXXX
XXXXXXXXXXXX
XXXXXXXXXXXX