XXXXXXXXXXX
XXXXXXXXXXX
X  XXXXXXXX
X      XXXX
X  X   XXXX
X    XD  XX
XX       XX
XX  D X  XX
XX       XX
XXXXXXXXXXX
XXXXXXXXXXX