XXXXXXXXXXXXXXXXXXXX
XX    XXXXXXXXXXXXXX
XX     D      XXXXXX
XX    XXXXXXX XXXXXX
XXXX XXXXXXXX XXXXXX
XXX   XXXXXXX XXXXXX
XXX  pXXXXXXX XXXXXX
XXX   XXXXXXX XXXXXX
XXX   XXXXXXXDXXXXXX
XXX p XXXXXX   XXXXX
Xp    X   XX   XXXXX
X              XXXXX
X          X   XXXXX
X          X   XXXXX
X     p    X     XXX
X          X     XXX
XX               XXX
XX    X    X     XXX
XXXXXXXXXXXXXXXXXXXX
XXXXXXXXXXXXXXXXXXXX