XXXXXXXXX
XXXXXXXXX
XXXXXXXXX
XX  XXXXX
XXp XXXXX
X   XXXXX
X   XXXXX
XXXXXXXXX
XXXXXXXXX