XX XXXXXXX
XXXXXXXXXD
  XXXXXXX 
X XXXXXXX 
X  XXXXXX 
X XXXXXXX 
XXXXXXXXXX
XXXXXXXXXX
XXXXXXXXXD
XXXXXXXXXX