XXXXXXXXXXXXXXXXX
XXXXXXXXXXXXXXXXX
X  XXXXXXXXXXXXXX
X    XXXXXX    XX
XX     XXXX    XX
XX     XXXXXX XXX
XX       D   XXXX
XX     XXXX   pXX
XX             XX
XXXXD XXXXXXX XXX
XXX    XXXXXX XXX
XXX         XDXXX
XXXXXXXX     XXXX
XXXXXXXXXXXXXXXXX
XXXXXXXXXXXXXXXXX
XXXXXXXXXXXXXXXXX
XXXXXXXXXXXXXXXXX