XXXXXXXXXXXXXXXXXXXX
XX  XXXXXXXXXXXXXXXX
XX  XXXXXXXXXXXXXXXX
XX         XXXXXXXXX
XX  X    X XXXXXXXXX
XXX X    X XX     XX
XXX XXX XX XX     XX
XXX   p  D        XX
X       XX XX     XX
X              XXXXX
X          XXXXXXXXX
XX     X   XXXXXXXXX
XXX        XXX   XXX
XXX        XXX   XXX
XXX          D   XXX
XXX        XXX   XXX
XXX       XXX   XXXX
XXXXXXXXXXXXX  XXXXX
XXXXXXXXXXXXXXXXXXXX
XXXXXXXXXXXXXXXXXXXX