XXXXXXXXXXXXXXX
XXXXXXXXXXXXXXX
XXXXXXXXXXXXXXX
XXXXXXXXXXXXXXX
XXXXXXXX    XXX
XXXXXXXX    XXX
XXXXXXXX  p XXX
XXXX  p XX XXXX
XX   p pD XXXXX
XX     XXXXXXXX
X     XXXXXXXXX
X     D      XX
X            XX
XXXXXXXXXXXXXXX
XXXXXXXXXXXXXXX