XXXXXXXX
XXXX  XX
X  X  XX
X pXXDXX
X  X  XX
X     XX
XXXXXXXX
XXXXXXXX