XXXXXXXX
XXXXXXXX
X  X  XX
X     XX
X  X  XX
X  D  XX
XXXXXXXX
XXXXXXXX