XXXXXXXXXXX
XXXXX  XXXX
XX  X  XXXX
XX     XXXX
XXX    XXXX
XXX    XXXX
X  X   XXXX
X     XXXXX
XX   XXXXXX
XXXXXXXXXXX
XXXXXXXXXXX