XXXXXXXXXX
XXXXXXXXXX
X  XXXXXXX
X  X  XXXX
XX X  XXXX
Xp  X XXXX
X       XX
X  XX   XX
XXXXXXXXXX
XXXXXXXXXX