XXXXXXXXXXXXXXXXXXXX
XXXXXXXXXXXXXXXXXXXX
XXXXXXXXXXXXXXXXXXXX
XXXXXXXXXXXXXXXXXXXX
XXXXXXXXXXXXXX   XXX
XXXXX       D    XXX
X  XX XXXXXXXXX XXXX
X  XX XXXXXXXXX XXXX
X       XXXXXXX XXXX
X  X         D   XXX
XX     XXXXXXXX  XXX
XX         DXXXD XXX
XXD      XX XXX  XXX
XX X     XX XXX  XXX
XX X        XXX DXXX
XXD         XX    XX
XXXX        XX    XX
XXXX        XXXXXXXX
XXXXXXXXXXXXXXXXXXXX
XXXXXXXXXXXXXXXXXXXX