XXXXXXXXXXXXXXXXXXXXX
XXXXXXXXXXXXXXXXX  pX
XXXXXXXXXXXXXXXXX X  
 XXXXXXXXXX          
XXXXXXXXX     XXX XXX
XXXXXXXXXXXXXXXXXXXX 
XXXXXXXXXXXXXXXXXXXXX
XXXXXXXXXXXXXXXXXXXXX
XXXXXXXXXXXXXXXXXXXXX
XXXXXXXXXXXXXXXXXXXXX
XXXXXXXXXXXXXXXXXX X 
XXXXXXXXXXXXXXXXX    
XXXXXXXXXXXXXXXXXp   
XXXXXXXXXXXXXXXXXXXX 
XXXXXXXXXXXXXXXXXXXX 
XXXXXXXXXXXXXXXXXXXXX
XXXXXXXXX     XXXX X 
XXXX  X   X   XXX    
XX  D    XXXX     XXX
XXXXXXXXXXXX   X  XX 
XXXXXXXXX XXXX       