XXXXXX XXXXXXXXXXXXXXX
XXXXXX  XXXXXXXXXXXXX 
XXXXXXX XX XXXXXXXX   
XXXXXXX     XXXXX  DX 
XXXXXXX  XXDXXXX    p 
XXXXXXXXXXX XX        
XXXXXXXXXXX     X   X 
XXXXXXXXXXXXXXXXXX XXX
XXXXXXXXXX    XXXXXXXX
XXXXXXXXX DXX   D   D 
XXXXXXXX  XXX  XX  XXX
XXXXXX   XXXXXXXX XXX 
XXXXXX XXXX X XXX XX  
XXXXXXX   p           
XXXXXXX X X          X
XXXXXXXXX   XXX XXXXXX
XXXXXXXXXXXXXXXXXXXX  
XXXXXXXXXXXXXX XXXX   
XXXXXXXXXXXXXXp X  XXX
XXXXXXXXXXXXXX       X
XXXXXXXXXXXXXXX XXXX  
XXXXXXXXXXXXXXXXXXXXXX