XXXXXXXXXXXXXX
XXXXXXXX  XXXX
X  p     pXXXX
X         XXXX
X  pXXXXXXXXXX
X       XXXXXX
XX  XXX XXXXXX
XX  XX   XXXXX
X        X  XX
X           XX
XX       X  XX
XX       XXXXX
XXXXXXXXXXXXXX
XXXXXXXXXXXXXX