XXXXXXXXXXXXXXXXXXXX
X  XXXXXXXXXXXXXXXXX
X  XXXXXXXXXXXXXXXXX
X      D  XXXXXXXXXX
X  XXXXXX XXXXXXXXXX
X  XXXXXX XXXXXXXXXX
XX     XX XXXXXXXXXX
XX     XX XXXXXXXXXX
X      XX XXXXXXXXXX
X  p XXX   XXXXXXXXX
X                XXX
X    p     XXXXX XXX
X p    X   XXXXX XXX
XXX  XXX   XXXX   XX
XXX  D     D      XX
X    XXXXXXXXXX   XX
X    XXXXXXXXXXXXXXX
X    XXXXXXXXXXXXXXX
XXXXXXXXXXXXXXXXXXXX
XXXXXXXXXXXXXXXXXXXX