XXXXXXXXXXXXXXXX
XXXXXXXXXXXXXXXX
XXX  XXXXXXXXXXX
XXX  XXXXXXXXXXX
XXX  XXXXXXXXXXX
XXX  XXXXXXXXXXX
XXX  XXXXXXXXXXX
XXX  XXXXXXXXXXX
X    XXXXXXXXXXX
X     XXXX    XX
X             XX
X     p  X    XX
X        D    XX
X   XX   XXXXXXX
XXXXXXXXXXXXXXXX
XXXXXXXXXXXXXXXX