XXXXXXXX XX
XXX XXXXXXX
    XXXXXXX
XXXpXXXXX  
XXXXXXXXX  
XXXXXXXX   
XXXX       
XXXX XXX XX
XXXXXXXXDXX
XXXXXXXXXXX
XXXXXXXXX p