XXXXXXXXXXXXXXXX
XXXXXXXXXXXXXXXX
XXX  XXXXXXXXXXX
XXX  XXXXXXXXXXX
X    XXXXXXXXXXX
X   D  XXXXXXXXX
X      XXXXXXXXX
XXXX       DXXXX
XXXX   XXX   XXX
XXX     DD   XXX
XXX  XXXXXXXXXXX
X    XXXXXXXXXXX
X    XXXXXXXXXXX
XXXXXXXXXXXXXXXX
XXXXXXXXXXXXXXXX
XXXXXXXXXXXXXXXX