XXXXXXXXXXXXXXXXXXXXX
XXXXXXXXXXXXXXXXXXXXX
XXXXXXXXXXXXXXXXXXXXX
XXXXXXXXXXXXXXXXXXXXX
XXXXXXXXXXXXXXXXXXXXX
XXXX XXXXXXXXXXXXXXXX
XXXX XXXXXXXXXXXXXXXX
XXXXpXXXXXXXXXXXXXXXX
XXXX  XXXXXXXXXXXXXXX
XXXXX   XXXXXXXXXXXXX
XXXXXXX  XXXXXXXXXXXX
XXXXXXXX  XXXXXXXXXXX
XXXXXXXXX XXXXXXXXXXX
XXXXXXXX  XXXXXXXXXXX
 XXXX XX   XX  XXXX  
XXXXX XXXX  D  XXXXX 
XXXXX XXXXX XX XXXX  
X  XXDXXXXX X  XX   X
XX XX XXX D X XX  DXX
XX    XXXX     X   XX
XX   XX      XXX   XX