    XXXX
XXX   XX
XXX   XX
XX  X XX
XX   XXX
XXXXXXXX
XXXXXXXX
XXXXXXXX