XXXXXXXXXXXXXXXXXX
XXXXXXXXX   XXXXXX
XXXXD       XXXXXX
XXXX XXXX   XXXXXX
XX   XXXXX    XXXX
XX             XXX
XXXX XXXXX X X XXX
XXXX XXXXX X   XXX
XX    XXXX X   XXX
XX    XXXX X   XXX
XX     XXX XX  XXX
XX       X XXXXXXX
XX       X XXXXXXX
XXXX      XXXXXXXX
XXXX     XXXXXXXXX
XXXX     XXXXXXXXX
XXXXXXXXXXXXXXXXXX
XXXXXXXXXXXXXXXXXX