XXXXXXXXXXXXXXXXXXXXXX
XXXXXXXXXXXXXXXXXXXXXX
XXXXXXXXXXXXXXXXXXXXXX
XXXXXXXXXXXXXXXXXXXXXX
XXXXXXXXXXXXXXXXXXXXXX
XXXXXXXXXXXXXXXXXXXXXX
XXXX      XXXXXXXXXXXX
XXXX   p  XXXXXXXXXXXX
XXXX  p   XXXXXXXXXXXX
XXXX    p        D  XX
XXXX      XXXXXXXXXDXX
X         p     XXX XX
X       XX      XXX XX
X       XX      XXX XX
X        X      XXX XX
X        X      XX  XX
X        X      XX  XX
X               D   XX
X     p  XXXXXXXXX  XX
XXX      XXXXXXXXX  XX
XXXXXXXXXXXXXXXXXXXXXX
XXXXXXXXXXXXXXXXXXXXXX