XXXXXXXXXXXXXXXXX
XXXXXXXXXXXXXXXXX
XXXXXXXXXXXX   XX
X  XXXXXXD     XX
X     XXX XXX XXX
X     XX  XXX XXX
X     XX  XXX XXX
X     XX  XXX XXX
XX            XXX
XX       D    XXX
XX       XXX  XXX
XX       XX   XXX
XX     p      XXX
XX       XXXXXXXX
XXXXX    XXXXXXXX
XXXXXXXXXXXXXXXXX
XXXXXXXXXXXXXXXXX