XXXXXXXXXXXXXXXXX
XXXXXXXXXXXXXXXXX
XXXXXXXXXXXXXXXXX
XXXXXXXX    XXXXX
XXXXXXXX   pXXXXX
XXXXXXXX    X  XX
XXXXXX         XX
XXXXXX    XXXX XX
XXXXXX    XXXX XX
XXXXXXXXXXXXXX XX
XXXXXXXXXXXXXX XX
XXXXX    XXXXX XX
XXXXX    XXX   XX
XXXX     XXX  XXX
XXXX      D  XXXX
XXXXXXXXXXXXXXXXX
XXXXXXXXXXXXXXXXX