XXXXXXXXXXXX
XXXXXXXXXXXX
XXXXXXXXXXXX
X   XXX  XXX
X        XXX
X    XXXXXXX
Xp   XXX  XX
X         XX
XXX   XXXXXX
XXX   XXXXXX
XXXXXXXXXXXX
XXXXXXXXXXXX