XXXXXXXXXXXXXXXXXXXXX
XXXXXXXXXXXXXXXXXXXXX
XXXXXXXXXXXXXXXXXXXXX
XXXXXXXXXXXXXXXXXXXXX
XXX     XXXXXXXXXXXXX
XXX     XXXXXXXXXXXXX
XXX     XXXXXXXXXXXXX
XXX     XXXXXXXXXXXXX
XXX     XXXXXXXXXXXXX
XXXXXDXXXXXXXXXXXXXXX
XXXXX     XXXXXXXXXXX
X         XX     XXXX
X         XX     XXXX
X          X     XXXX
X                XXXX
X          X     XXXX
X        XXX     XXXX
X        XXXXXXXXXXXX
X      XXXXXXXXXXXXXX
XXXXXXXXXXXXXXXXXXXXX
XXXXXXXXXXXXXXXXXXXXX