XXXXXXXXXXXXXXXX
XXXXXXXXXXXXXXXX
XXXXXXXXXXXXXXXX
XX  XXXXXXXXXXXX
XX   XXXXXXXXXXX
XX   Xp  XXXXXXX
XXX  X   XXXXXXX
XXX  X   XXXXXXX
X    X   XXXXXXX
X        XXXXXXX
X        XXXXXXX
X            XXX
XXX       D  XXX
XXXXX     X  XXX
XXXXXXXXXXXXXXXX
XXXXXXXXXXXXXXXX