XXXXXXXXXXXXXXXXX
XXXX   XX  XD  XX
XXXX XDXXX     XX
XXXX X  XX   XXXX
XXXX    XXXX  XXX
XXXX D  XXXX XXXX
XXXX    XXXXDXXXX
XX    X XXXX XXXX
X  XXXX   XXXXXXX
X   XXXX  XXXXXXX
XX  XXXXX XXXXXXX
XXX XXXXX XX     
XXX   XXXDXX  XXX
XXX XXXXX XXX   X
XXX XXXXX XXXXX  
XXX    XXXXXXXXXX
XXXXX XXXXXXXXXXX