XXXX XXXXXX
XX   X XXXX
XXX    XXXX
 XX    XXXX
XXX     XXX
XXXXX XXXXX
XX    XXXXX
XXXXXXXXXXX
XXXXXXXXXXX
XXXXXXXXXXX
XXXXXXXXXXX