XXXXXXXXXXXXXXXXX
XXXXXXXXXXXXXXXXX
XXXXXXXXXXXXX XXX
XXXXXXXXXXXXX XXX
XXXXXXXXXXXXXppXX
XXXXXXXXXXXXXX   
XXXXXXXXXXXXXX  X
XXXXXXXXXXXXXX  X
XXXXXXXXXXXXXXX X
XX XXXXXXX   X   
XX XXX XXXXX     
XX XXX    XXXX   
XX XXXXX XXXXXX  
XX   XXX XXXXXXX 
XX  XXXX   XXXXXX
XX  pXXX   XXXXXX
X  XpX    X XXXXX