XXXXXXXXXXXXXXXXXXXXXXX
XXXXXXXXXXX   XXXXXXXXX
XXXXXXXXXXXp  XXXXXXXXX
XXXXXXXXXXX   XXXXXXXXX
XXXXXXXXXXXX XXXXXXXXXX
XXX    XXXXX XXXXXXXXXX
XXX    XXXXX X     XXXX
XXX      XXX X      XXX
XXX    X XXX XXX XX XXX
XXX    X XXX XXX XX XXX
XXXXX      X       DXXX
XXXXX p             XXX
XX        p         XXX
XX              XXX XXX
XX p     DXX XXXXXX XXX
XXp       X  XXXXXX XXX
XX              XXX XXX
XX        p     XX  XXX
XX             p    XXX
XX   XX             XXX
XX   XX  XXX      XXXXX
XXXXXXXXXXXXXXXXXXXXXXX
XXXXXXXXXXXXXXXXXXXXXXX