XXXXXXXXXXX
XXXXXXXXXXX
XX  XXXXXXX
XX  XXXXXXX
XX XXXXXXXX
XX   XXXXXX
X    D   XX
X   XXX  XX
XXXXXXXXXXX
XXXXXXXXXXX
XXXXXXXXXXX