XXXXXXXXXXXX
XXXXXXXXXXXX
XXXXXXX   XX
XXXXXXX   XX
XXXXXXXX XXX
X  XXXXX XXX
X        XXX
X   XX   XXX
XX  XX  XXXX
XXXXXXXXXXXX
XXXXXXXXXXXX
XXXXXXXXXXXX