XXXXXXXXXXXXXXX
XXXXXXXXX   XXX
XXXXXXXXX   XXX
XX          XXX
XX  p XXX   XXX
XX    X    XXXX
XX    X   XXXXX
X    XXX XXXXXX
X         DXXXX
X    XXXD  XXXX
X    p     XXXX
X       XXXXXXX
XX   p  XXXXXXX
XXXXXXXXXXXXXXX
XXXXXXXXXXXXXXX