XXXXXXXXXXXXXXXXXXXXX
XXXXXXXXXXXXXXXXXXXXX
XXXXXXXXXXXXXXXXXXXXX
XXXXXXXXXXXXXXXXXXXXX
X   XXXXXXXXXXXXXXXXX
X   XXX      XXXXXXXX
X   XXX       DDXXXXX
X       XX XXXX XXXXX
X   XXX XXDXXXX XXXXX
X       XX XXXX XXXXX
XX          XXX XXXXX
XX p        XXX XXXXX
X            XX XXXXX
X            XX XXXXX
X            XXDXXXXX
XXXX   p      p  XXXX
XXX       XXX    XXXX
XXX              XXXX
XXX       XXX    XXXX
XXXXXXXXXXXXXXXXXXXXX
XXXXXXXXXXXXXXXXXXXXX