XXXXXXXXXXXXXXXXX
XXXXXXXXXXXXXXXXX
XXXXXXXXXXXXXXXXX
XXXXXXXXXXXXXXXXX
XXX  XXXXXXXXXXXX
XXX  XXXXXXXXXXXX
XXX  XX    XXXXXX
XX   XX    XXXXXX
Xp         XXXXXX
X p    X XXXXXXXX
X        XXXX  XX
X              XX
X  p           XX
X   XX    XXXXXXX
XX   D  ppXXXXXXX
XXXXXXXXXXXXXXXXX
XXXXXXXXXXXXXXXXX