XXXXXXXXXXXXXXXXXXXX
XXXXXXXXXXXXXXXXXXXX
XX     XXXXXXXXXXXXX
XX        D  XXXXXXX
XXXX XXXXXXX XXXXXXX
XXXX XXXXX    XXXXXX
X  p XXXXX    XXXXXX
X     XXXX       XXX
X      XXXp   XX XXX
X  p    XX    XX XXX
X    X  XXXX  XX XXX
X             XX XXX
XX        XX  XX XXX
XX           XXX XXX
XX        XXXXX  XXX
XX               XXX
XXX      XXXXXX  XXX
XXXXXXXXXXXXXXXXXXXX
XXXXXXXXXXXXXXXXXXXX
XXXXXXXXXXXXXXXXXXXX