XXXXXXXXXXXXXXXXXXXXXX
XXXXXXXXXXXXXXXXXXXXXX
XXXXXXXXXXXXX  XXXXXXX
XXXXXXXXXXXXX  XXXXXXX
XXXXXXXXXXXXXX  XXXXXX
XXXXXXXXXXXXX    XXXXX
XXXXXXXXXXXXXX   XXXXX
  XXXXXXXXXXXX  XXXXXX
X  XXXXXXXXXXX  XXXXXX
XDXXX  XXXXXXXX  XXXXX
XXXXX   XXXXXXX   XXXX
XXXXXXX XXXXXXXX  XXXX
XXXXXXX XXXXXXXX  XXXX
XXX  XX XXXXXXX    XXX
XX    X  XXXXXXXXX XXX
XXDX XXX  XXXXXXXX   X
XXDX XXX DXXXXXXXX   D
XX X XXX  XXXXXX     X
X     XXX X  XXXX    X
XX  XXXXX X XXXX      
X pXXXX   X XXXX X   X
XX  XXX XXX DXX     XX