XXX XXXXXXXXX
 X  XXXXXXXXX
XX   XX XXXXX
XX  XXX XXXXX
XX      XXXXX
XX   XXXXXXXX
X     XXXXXXX
XXX X XXXXXXX
X   D XXX  XX
X X  XXXXX XX
X  X XXXXX  X
XX    XXXXX X
X     XXXXXp 