XXXXXXXXXXXXXXXXXXXXXXXX
XXXXXXXXXXXXXXXXXXXXXXXX
XXpp  XXXXXXXXXXXXXXXXXX
XX                XXXXXX
XX    XXXXXXX       XXXX
XXXX XXXXXXXX       XXXX
XXXX X      X       XXXX
XXXX X      X       XXXX
XXXX        XXXX  XXXXXX
XX          XXXX  XXXXXX
Xp          XXXX  XXXXXX
X    XX p     XX  XXXXXX
XX p          XX  XXXXXX
XX        XXXXXX  XXXXXX
XX       pXXXXX     XXXX
XX           XX     XXXX
XX   p      pXX     XXXX
XX           XXXXXXXXXXX
XX                 XXXXX
XX          p      XXXXX
XX  XXXXX       X  XXXXX
XXXXXXXXXXX     XXXXXXXX
XXXXXXXXXXXXXXXXXXXXXXXX
XXXXXXXXXXXXXXXXXXXXXXXX