XXXXXXXXXXXXXXXXXXXX
XXXXXX X XXXXXXXXXXX
XXXXXX X XXXXXXXXXXX
XXXXXX X X XXXXXXXXX
XXXXXX     XXXXXXXXX
XXXXXX X    X XXXXXX
XXXXX  XXX    XXXXXX
XXXXX         XXXXXX
XXXXX        XX XXXX
XXXXX XX X   XX XXXX
XXXXX XX X  XXX  XXX
XXXXX XX X   XXX XXX
XXXXX XX   D XXX  XX
XXXXX XXX   pX  X XX
XXXXX XX        Xp  
XXXXX XXXX      XX X
XXXXX XXXX      XX X
XXXXX XXXX p   XXX X
XXXXX   X       XX  
XXXXXXX X       XXXX