XXXXXXXXXXXXXXXX
XXXXXXXXXXXXXXXX
XXXXXXXXX    XXX
XXXX    D    XXX
XXX   XXXp   XXX
XXX   XXXXX XXXX
X     XXXXX XXXX
X     XXXXX XXXX
XX     XXXX XXXX
XX            XX
XX    XXXX    XX
XX XXXXXXX    XX
XXp  XXXXXXXXXXX
XX   XXXXXXXXXXX
XXXXXXXXXXXXXXXX
XXXXXXXXXXXXXXXX