XXXXXXXXXXXX
XXXXXXXXXXXX
XX  pXXXXXXX
XX   XXX  XX
XX      p XX
X    XXX  XX
X    XXXXXXX
X      XXXXX
X      XXXXX
XXXXX  XXXXX
XXXXXXXXXXXX
XXXXXXXXXXXX