XXXXXXXXXXXXXXXXXXX
XXXXXXXXXXXXXXXXXXX
XXXXXXXXXXXXXXXXXXX
XXXXXXXXXXXXXXXXXXX
XXXXXXXXXXXXXXXXXXX
XXXXXXXXXXXXXXXXXXX
XXX  XXXXXXXXXXXXXX
XXX      pXXXXXXXXX
XXX       XXXXXXXXX
XXXX      XX    XXX
XXXX   p  XX    XXX
XXX             XXX
XXX       XX    XXX
XXX      D      XXX
XXX      XXXXXXXXXX
XXXX       XXXXXXXX
XXXXD    p XXXXXXXX
XXXXXXXXXXXXXXXXXXX
XXXXXXXXXXXXXXXXXXX