XXXXXXXXXXXXXXXXX
XXXXXXXXXXXXXXXXX
XXXXXXXXX   XXXXX
XXXXXXXXX    XXXX
XXXXXXXXXX X XXXX
XX   XXXXX X XXXX
XX    XXXX X XXXX
XX      XX X XXXX
XX    X XX X XXXX
XX pXX   X X XXXX
XX  XX     X XXXX
XX  XX     XDXXXX
XXX XXXX   X XXXX
XXXDXXXX p    XXX
XXX DD        XXX
XXXXXXXXXXXXXXXXX
XXXXXXXXXXXXXXXXX