XXXXXXXX
XXXXXXXX
X  X  XX
Xp D  XX
X     XX
X    XXX
XXXXXXXX
XXXXXXXX