XXXXXXXXXXXXXXXXXXXXX
XXXXXXXXXXXXXXXXXXXXX
XXXXXXXXXXXXXXXXXXXXX
X  X   XXXXXXXXXXXXXX
X  X   XXXXXXXXXXXXXX
X  X  XXXXXXXXXXXXXXX
X     XXXXXXXXXXXXXXX
X  X  XXXXXXXXXXXXXXX
X      XXXXXXXXXXXXXX
XX     XXXXXXXXXXXXXX
XX        XXXX     XX
XX      X XXXX     XX
XX                 XX
XX                 XX
XX        XXXX     XX
X        XXXXXXXXXXXX
X       XXXXXXXXXXXXX
XX      XXXXXXXXXXXXX
XX      XXXXXXXXXXXXX
XXXXXXXXXXXXXXXXXXXXX
XXXXXXXXXXXXXXXXXXXXX