XXXXXXXXXXXXXXXX
XXXXXXXXXXXXXXXX
XXXXXXXXXXXXXXXX
X   XXXXXXXXXXXX
X      XXXXXXXXX
X   X  XXXXXXXXX
XX XX  XXXXXXXXX
X   X  XXXXX pXX
X    X        XX
X        XXX  XX
XX       XXXX XX
XX         XX XX
XX           XXX
XXX   p   XXXXXX
XXXXXXXXXXXXXXXX
XXXXXXXXXXXXXXXX