XXXXXXXXXXXXXXXXXXXXXXXX
XXXXXXXXXXXXXXXXXXXXXXXX
XXXXXXXXXXXXXXXXXXXXXXXX
XXXXXXXX  XXXXXXXXXXXXXX
XXXXXXXX  XXXXXXXXXXXXXX
XXXXXXXX  XXXXXXXXXXXXXX
X    XXX       D   XXXXX
X    XXX  XXXXXXXX XXXXX
X              XXX XXXXX
X     D   XXXX XXX XXXXX
X    XXXX XXXX XXX XXXXX
XXX     X XXXXDXXX XXXXX
XXX       XXXX XXX XXXXX
XX          XX       XXX
XX          XX       XXX
X            X       XXX
X                    XXX
X           p        XXX
XX    X p      X      XX
XXXX  Xpp  p          XX
XXXX                  XX
XXXXXXX p             XX
XXXXXXXXXXXXXXXXXXXXXXXX
XXXXXXXXXXXXXXXXXXXXXXXX