XXXXXXXXXXXXXXXXX
XXXXXXXXXXXXXXXXX
XXXXX   XXXXXXXXX
XXXXX   XXXXXXXXX
XXXXX   XXXXXXXXX
XX     XXXXXXXXXX
XX         XXXXXX
XX    D   pX   XX
XX   X         XX
XX     D      pXX
XX   X XX     XXX
XXX  X XX    XXXX
XX      X    XXXX
XX       XXXXXXXX
XX      XXXXXXXXX
XXXXXXXXXXXXXXXXX
XXXXXXXXXXXXXXXXX