XXXXXXXXXXXXXXXXXXXXXXXX
XXXXXXXXXXXXXXXXXXXXXXXX
XXXXXXXXXXXXXXXXXXXXXXXX
X       XXXXXXXXXXXXXXXX
X       XXXXXXXXXXXXXXXX
X       XXXXXXXXXXXXXXXX
X                  XXXXX
X       XXXXp      XXXXX
X       XXXX       XXXXX
XXXX XXXXXXXXXX XX XXXXX
XXXX p    XXXXX X  XXXXX
XXXX  p            XXXXX
XXXX      XXXXX X  XXXXX
XXXX          X XXXXXXXX
XXXX      XXX X XXXXXXXX
X         XX    XXXXXXXX
X               XXXXXXXX
X  p            XXXX  XX
X                     XX
X                    XXX
XXX               XXXXXX
XXX       XXXXXX  XXXXXX
XXXXXXXXXXXXXXXXXXXXXXXX
XXXXXXXXXXXXXXXXXXXXXXXX