XXXXXXXXXXXXXXXXXXXX
XXXXXXXXXXXXXXXXXXXX
XXX  XXXXXXXXXXXXXXX
XXX  XXXXXX  XXXXXXX
XXX          XXXXXXX
XXX  XXXXXX  XXXXXXX
XXX  XXXXXX  X  XXXX
XXXX XXXXXX  X  XXXX
XXXX XXXX       XXXX
XXXX XXXX X  X  XXXX
XX   XXXX X  XX XXXX
XX   XXXX X  XX XXXX
XX     p       XXXXX
XX         D XXXXXXX
XXXXXXX      XXXXXXX
XXXXXXXXXX   XXXXXXX
XXXXXXXXXX   XXXXXXX
XXXXXXXXXX   XXXXXXX
XXXXXXXXXXXXXXXXXXXX
XXXXXXXXXXXXXXXXXXXX