XXXXXXXXXXXXXXXXXXXX
XXXXXXXXXXXXXXXXXXXX
XXXD XXXXXXXXXXX XXX
XXXX  XXXXX XXX  XXX
XXXX  XXXXX  XX XXXX
XXXX   XXXXX XX XXXX
XXXXXX XXXXX XX  XXX
X XXX  XXXX  XX  XXX
X XXX XXXXX XXX   XX
X XXX XXXX   XXX XXX
XXX    XXX XXXXX  XX
XXXXXX  XX  XXXX    
XXXXX  XXX  XXXX X  
XXX    X     XX  X  
XXX      X X  X     
XXX  p       XX XX  
XX     X X  XX  XXX 
XX XX    X     XXXX 
X  X     X  XXXXXXXX
XX XX    X   XXXXXXX