XXXXXXXXX
Xp XXXXXX
X   XXXXX
XXX XXXXX
XXX X  XX
XX  X  XX
XX    XXX
XXXXXXXXX
XXXXXXXXX