XXXXXXXX XXXXXXXXXX
XXXX    XX XX DXXD 
XXXXXX  XX     XXXX
XXXXXX  X      XXXX
XXXXXX  X     XXXXX
XXXXXX XX X   XXXXX
XXXX      XX  XXXXX
XXXXpX DXXXX XXXXXX
XXXX  XXXXXX XXXXXX
XX   XXXXXXX XXXXXX
XX  XXXXXXXXDXXXXXX
XX XXXXXXXXXXXXXXXX
XX XXXXXXXXXXXXXXXX
XXXXXXXXXXXXXXXXXXX
XXXXXXXXXXXXXXXXXXX
XXXXXXXXXXXXXXXXXXX
XXXXXXXXXXXXXXXXXXX
XXXXXXXXXXXXXXXXXXX
XXXXXXXXXXXXXXXXXXX