XXXXXXXXXXXXX
XXXXXXXXXXXXX
X XXXXXXXXX X
XXXXXXXXXXX X
XXXXXXXXXXX X
XXXXXXXXXX  X
XXXXXXXX   XX
XXXX  XX  XXX
XXXXX XX X XX
XXXX  XX     
XXXX  X  X   
XXXXX    XXpX
XXXX  XXX p  