XXXXXXXXXXXXXXXXXX
XXXXXXXXXXXXXXXXXX
XXXXXXXXXXXXXXXXXX
XXXXX  XXXXXXXXXXX
X  XX        XXXXX
X  XXX XXXXX XXXXX
X   XX XXXXX XXXXX
X      X     XXXXX
X               XX
X         XX XX XX
X   p  X XXX XX XX
Xp         X X  XX
X       p       XX
XX           XXXXX
XXXXXX       XXXXX
XXXXXX     XXXXXXX
XXXXXXXXXXXXXXXXXX
XXXXXXXXXXXXXXXXXX