XXXXXXXXXXXXX
XXXXXXXXXXXXX
XXXXXXXXXXXXX
XXXXXXXXXXXXX
X   XXXXXXXXX
X        XXXX
X        XXXX
X    X   XXXX
X    XXXXXXXX
X  D       XX
X  X       XX
XXXXXXXXXXXXX
XXXXXXXXXXXXX