XXXXXXXXXXXXXXXXXX
XXXXX XXXXX XXXXXX
XXXXXXXXXXXXXXXXXX
XXXXXXXXXXXXXXXXXX
XXXXXXXXX      X  
XXXXXXXXXXXXXX    
XXXXXXXXXXXXX     
XXXXXXXXXXXXXXXXX 
XXXXXXXXXXXXXXXXXX
XXXXXXXXXXXXXXXXXX
XXXXXXXXXXXX    XX
XXXXXXXXXXX   X X 
XXXXXXXXXXX XXX   
XXXXXXXXXXXXXXXXXX
XXXXXXXXXXXXX   XX
XXXXX XXXXXXX   XX
XXX      XXXXX    
XXXXX DX XXXXXXXXX