XXXXXXXXXXXXXXXXXXXXX
XXXXXXX     XXXXXXXXX
XXXXXXX     XXXXXXXXX
XXXXXXX     XXXXXXXXX
XXXXX      XXXXXXXXXX
XXXXX   p  XXXXXXXXXX
XX       p XXXXXXXXXX
XX XX      XXXXXXXXXX
XX XXXXX  XXXXX  XXXX
XX XXXXX  XXXXX  XXXX
XX XXXXX         XXXX
XX     X XXXXXX pXXXX
XX p   X XXXXXX  XXXX
XX        XXXXXX XXXX
XX        XXXXXX XXXX
XX       XXXXXXX XXXX
XX       XXXXXXX XXXX
X  XXX   XXXXXXX XXXX
X               XXXXX
XXXXXXXXXXXXXXXXXXXXX
XXXXXXXXXXXXXXXXXXXXX