XXXXXXXXXXXXXXXXXXXXXX
X  XXXXXXXXXXXXXXXXXXX
X   X     XXXXXXXXXXXX
XX  X     XXXXXXXXXXXX
XX  X     XXXXXXXXXXXX
XX  X     XXXXXXXXXXXX
XX  X     X     XXXXXX
XX  X           XXXXXX
XX      XXXXX XXXXXXXX
XX   p    XXX XXXXXXXX
XX  p     XXX XXXXXXXX
XX        XXX XXXXXXXX
X         XXX XXXXXXXX
Xp         XX XXXXXXXX
X      p   D     p  XX
X          XX       XX
X    p    XXX       XX
X                   XX
XX          XXp     XX
XX      XXXXXX      XX
XXXXXXXXXXXXXXXXXXXXXX
XXXXXXXXXXXXXXXXXXXXXX