XXXXXXXXXXXXXXXXX
XXXXXXXXXXXXXXXXX
XXXXXXXXXXXXXXXXX
XXXXXXXXXXXXXXXXX
XXXXXXXX      X X
XXXXXXXXXXXXX    
XXXXXXXXXXXXXX   
XXXX        X    
XX   XXXX       X
XX XXX    XXXXXXX
X  XXXXXXXXXXXXXX
X XXXXXXXXXXXXXXX
XXXXX    XXX XXXX
XXXXXXXXD  X    X
XXXXXX         Dp
XXXXXXXXXXX     X
XXXXXXXXXXXXXX   