XXXXXXXXXX
XX XX    X
XX XX  X X
X   XX   X
XX XXX   X
XX  XXX XX
XX XXXX XX
XX XXXXXXX
XX XXXXXXX
XXXXXXXXXX