XXXXXXXXXXXXXX
XXXXXX   XXXXX
XXXXXX   XXXXX
XXXXXXX XXXXXX
XXXXXXX X p XX
XXXXXXX     XX
XXXX   X   XXX
XXXX       XXX
XXXX   X   XXX
XXXXXXXXXXXXXX
XXXXXXXXXXXXXX
XXXXXXXXXXXXXX
XXXXXXXXXXXXXX
XXXXXXXXXXXXXX