XXXXXXXXXXXXXXXXXX
XXXXXXXXXXXXXXXXXX
XXXXXXXXXXX    XXX
XXXXXXXXXXX    XXX
XX       D    pXXX
XX     XXXX    XXX
XXXXXXXXXXX    XXX
XXXXXXXXXXXXX XXXX
XXXXXX  XXXXX XXXX
XXXX    XX  X XXXX
XX   XX XX   XXXXX
XX       X  XXXXXX
XX        X   XXXX
XX            XXXX
XX   p     X  XXXX
XXXXXXXX   XXXXXXX
XXXXXXXXXXXXXXXXXX
XXXXXXXXXXXXXXXXXX