XXXXXXXXXXXXXXXX
X   XXXXXXXXXXXX
X   XXXXXXXXXXXX
X    XXXXXXXXXXX
X    XXXXXXXXXXX
X    XXXXXXXXXXX
X            XXX
X    XXX  XX XXX
Xp   XXX  XX XXX
X    XXX  X  XXX
X            XXX
XXX    XX X  XXX
XXX     X XXXXXX
XXXXX    XXXXXXX
XXXXXXXXXXXXXXXX
XXXXXXXXXXXXXXXX