XXXXXXXXXXXXXX
XXXXXXXXXXXXXX
XXXXXXXXXXXXXX
XXXXXXXXXXXXXX
X     XXXXXXXX
X     XXXXXXXX
X     XXXXXXXX
X    pp XXXXXX
X p        XXX
XX    XXX   XX
XX     D    XX
XXXXXXXXX   XX
XXXXXXXXXXXXXX
XXXXXXXXXXXXXX