XXXXXXXXXXXXXXXXX 
XD  XXX  XX       
X  XXXXX  X     XX
XX XXXXXX X X   XX
X  XXXX   X  D  XX
XD XXXXX      D XX
XXXXXXXXX  X  X XX
XXXXXXXD    D p XX
XXXXXXXXXXX     XX
X XXXXXXXXX XX XXX
XXXXXXXXXXX X  XXX
XXXXXXXXXXXXX  XXX
XXXXXXXXXXXXX    X
X XXXXXXXXXXXXXX X
X   XXXXXXXXXXXXXX
XXX XXXXXXXXXXXXXX
XXX XXXXXXXXXXXXXX
XX  XXXXXXXXXXXXXX