XXXXXXXXXXXXXXXXXXXX
XXXXXXXXXXXXXXXXXXXX
XXXXXXXXXXXXX  XXXXX
XXXX           XXXXX
XXXX XXXXXXXXX XXXXX
XXXX XXXXXXXXX XXXXX
XXX    XXXXXXX XXXXX
XXX     p     XXXXXX
XXXX D  p  XXXXXXXXX
XXXX       XXXXXXXXX
XXXX       XXXXXXXXX
XXX    X X XXXXXXXXX
X      X X  XXXXXXXX
X               XXXX
X p              XXX
XX               XXX
XX               XXX
XXXXXXX    pXX   XXX
XXXXXXXXXXXXXXXXXXXX
XXXXXXXXXXXXXXXXXXXX