XXXXXXXXXXXXXXX
XXXXXXXXXXXXXXX
XXXXXXXXXXXXXXX
XXXXXXXXXX XXXX
XXXX XXXXX XXXX
XXXX XXXXX XXXX
XXXXD  XXX XX X
  X  X XXX  X p
XXX  X XXX XXX 
XXX XX XXX  XX 
XXX XX     XXX 
XXX  pX    XXXX
XXXX       XXXX
XXXXX  X   XXXX
XXXXX  D  XXXXX