XXXXXXXXX XXXXX
XXXXXX   X    X
XXXXXX  XX  X  
XXXXXX         
XXXXXX X   XX p
XXXXXX     XXXX
XXXXXXXXXXXXXXX
XXXXX          
XXXXXXXXXXXX  X
XXXXXXXXXXXXXXX
XXXXXXXXXXXXXXX
XXXXXXXXXX  XXX
XXXXXXXX       
XXXXXXXXXXXXXXX
XXXXXXXXXXXXXXX