XXXXXXXXXXX
X  XXXXXXXX
X      p XX
XX X     XX
X  X  XXXXX
X     XXXXX
X  X  XXXXX
X  p  XXXXX
XX    XXXXX
XXXXXXXXXXX
XXXXXXXXXXX