XXXXXXXXXXXXXXXXX
XXXXXXXXXXXXXXXXX
XXXXXXXXXXXXXXXXX
XXXXXXXXXXXXXXXXX
XXX   XXXXXXXXXXX
XXX   XXXXXXXXXXX
XXXX  XXXXXXXXXXX
XXXX  XXXXXXXXXXX
XXXX     XXXXXXXX
X        XXXXXXXX
X      DXXXXXXXXX
X      XX  XXXXXX
XX      D  XXXXXX
XX     XXXXXXXXXX
XXX   XXXXXXXXXXX
XXXXXXXXXXXXXXXXX
XXXXXXXXXXXXXXXXX