XXXXXXXXXXXXXXXXXXXXX
XXXXXXXXXXXXXXXXXXXXX
XXXXXXXXXXXXXXXXXXXXX
XXXXXXXXXXXXXXXXXXXXX
X     X      XXXXXXXX
X     X      XXXXXXXX
X     X      XXXXXXXX
XXX X X      XXXXXXXX
XXX X X      XXXXXXXX
XXX X XX   XXXXXXXXXX
XXX X XX   XXXXXXXXXX
XXX    D   XXXXXXXXXX
XXXX   X   XXXXXXXXXX
XXXX   X X XXXXXXXXXX
XXXX XXX X XXXXXXXXXX
XX         XXXXXXXXXX
XX         XXXXXXXXXX
XX         X      XXX
XXXXX             XXX
XXXXXXXXXXXXXXXXXXXXX
XXXXXXXXXXXXXXXXXXXXX