XXXXXXXXXX
XXXXXXXXXX
X  XXXXXXX
X  XXXXXXX
XX  XXXXXX
X    XXXXX
X    X  XX
X     p XX
XXXXXXXXXX
XXXXXXXXXX