XXXXXXXXXXXXXX
XXXXXXXXXXXXXX
XXXXXXXXXXXXXX
X   XXXXXXXXXX
X    XXXXXXXXX
XXX  XXXXXXXXX
XXX  X   XXXXX
XXX      XXXXX
XXX XX   XXXXX
XX      X  XXX
XX         XXX
XX     XX  XXX
XXXXXXXXXXXXXX
XXXXXXXXXXXXXX