XXXXXXXXX
XX  X  XX
XX     XX
X   XX XX
X     pXX
X      XX
X     XXX
XXXXXXXXX
XXXXXXXXX