XXXXXXXXXXXXXXXXXX
XXXXXXXXXXXXXXXXXX
XXXXXXXXXXXXXXXXXX
X    pXXXXXXXXXXXX
X        XXXXXXXXX
X             D XX
XXX XXXX XXX    XX
X   XXXX XXXp   XX
X   XX          XX
Xp   D    XX    XX
X   XXXX XXXXX  XX
X        XXXXXD XX
X  p     XXXXX  XX
XX    p   XXXX  XX
XX       pXXXX  XX
XX        XXXXXXXX
XXXXXXXXXXXXXXXXXX
XXXXXXXXXXXXXXXXXX