XXXXXXXX
X  XXXXX
X     XX
X  X pXX
X pX  XX
XXXXXXXX
XXXXXXXX
XXXXXXXX