XXXXXXXXXX
XXXXXXXXXX
XX pXXXXXX
XX  XXXXXX
X  pXXXXXX
X   X  XXX
X   X  XXX
X     XXXX
XXXXXXXXXX
XXXXXXXXXX