XXXXXXXXXXXXXX
XXXXXXXXXXXXXX
XXXXXXXXXXXXXX
XXXXXXXXXXXXXX
X  XXXXXXXXXXX
Xp    XXXXXXXX
X      XXX  XX
XX          XX
XX      XXX XX
XX  X   XXX XX
XX    p     XX
XXXX        XX
XXXXXXXXXXXXXX
XXXXXXXXXXXXXX