XXXXXXXXXXXXXXXXXXXXXX
XXXXXXXXXXXXXXXXXXXXXX
XX      XXXXXXXXXXXXXX
XX      X  XXXXXXXXXXX
XX    p X  XXXXXXXXXXX
XX         XXXXXXXXXXX
XX      X  XXXXXXX  XX
XX      XXXXXXXXXX pXX
XX XX X             XX
XX XX X XXXXX   pX  XX
XX XX  p         X  XX
XX XXX  XXXXXXX XXX XX
XX XXX  XXXXXXX XXX XX
XX      XXXXXXX XXX XX
XX                 XXX
XX  p      XXXX XXXXXX
X              XXXXXXX
X          XXXXXXXXXXX
X     D XXXXXXXXXXXXXX
X   XXXXXXXXXXXXXXXXXX
XXXXXXXXXXXXXXXXXXXXXX
XXXXXXXXXXXXXXXXXXXXXX