XXXXXXXXXXXXXXX
XXXXXXXXXXXXXXX
XXXXXXXXXXXXXXX
X    XXXXXXXXXX
X p pXXXXXXXXXX
X    XXX  XXXXX
XX        X  XX
XX        X  XX
XX        D  XX
X    X    X  XX
X         XX XX
X            XX
X            XX
XXXXXXXXXXXXXXX
XXXXXXXXXXXXXXX