XXXXXXXXXXXXXXXXXX
XXX    XXXXXXXXXXX
XXX    XXXXXXXXXXX
XXX    XXXXXXXXXXX
XXX    XXXXXXXXXXX
XXXXX XXXXXXXXXXXX
XX  X XXXXXXXXXXXX
X     XXXXXXXXXXXX
X       XXXXXXXXXX
X       XXXXXXXXXX
X          XXX  XX
XX              XX
XX         XXXX XX
X              XXX
X            XXXXX
X     XXX  XXXXXXX
XXXXXXXXXXXXXXXXXX
XXXXXXXXXXXXXXXXXX