XXXXXXXXXXXXXXXXXXXXX
XX   X  XXXXX     X X
XXX     XXXXXX    XXX
XX    X XXXXX   X XXX
XX  XD  XXXXX    XXXX
XX      XXXXXX X XXXX
XXp     XXXXXX X  XXX
XX X D  XXXXX  XX XXX
XX  DXX XXXX  XXX XXX
XXX  X  XXXXD XXXXXXX
XXX  p XXXXX  XXXXXXX
XXXX  XXXXXX XXXXXXXX
XXXX  XXXXXX XXXXXXXX
XXXX   XXXXX XXXXXXXX
XXXX    XX   XXXXXXXX
XXXXX X X  XXXXXXXXXX
XXXXXXX XX XXXXXXXXXX
XXXXXXXXXX XXXXXXXXXX
XXXXXXXXXX  XXXXXXXXX
XXXXXXXXXX    XXXXXXX
XXXXXXXXXXXXX XXXXXXX