XXXXXXXXXXXXX
XXXXXXXXXXXXX
XXXXXXXXXXXXX
XXXXXXXXXXXXX
XXXXXXXXXXXXX
X    XXXXXXXX
X       XXXXX
X   XX  XXXXX
XXXXXX   XXXX
XXXXXX   XXXX
XXXXXX   XXXX
XXXXXXXXXXXXX
XXXXXXXXXXXXX