XXXXXXXX
XppXXXXX
X   DXXX
X  X XXX
X    XXX
XXX  XXX
XXXXXXXX
XXXXXXXX