XXXXXXXXXXXXXXXXXXX XXX
XXXXXXX  XXXX  XXXXXXX 
 XXXXX   XXXX XXXXXXXXX
XXXXXX   X X   XXXXXXXX
XXXXXXX        XXXXXXXX
XXXXXXXX       XXXXXXXX
XXXXXXXX  XX    XXXXXXX
XXXXX     XXXX    p X  
XXXXX XXXXXXXX         
XXXXX XXXXXXXXXXpDX  D 
XXXXX XXXXXXXXXXXXX    
XXXX  XXXXXXXXXXXXX  X 
XXX  XXXXXXXXXXXXX     
XXX XXXXXXXX    X  XXXX
XXXXXXXXXXX  XX   XXXXX
XXXXXXXXXXXXXXXXXX     
XXXXXXXXXXXXXXXXXXXX  X
XXXXXXXXXXXXXXXXXXXXXXX
XXXXXXXXX  XXXXXXXXXXXX
XXXXXXXX   XXXXXXXXXXXX
XXXXXXXX Xp    XXXXXXXX
XXXXXXXX XX  X  XXXXXXX
XXXXXXXXXXXXXXX XXXXXXX