XXXXXXXXXXX
XXXXXXXXXXX
XXXX  XXXXX
XXX   XXXXX
XXX XXXXXXX
XXX XXXXXXX
XXX XXX  XX
XX  XXX  XX
XX      XXX
XXXXXXXXXXX
XXXXXXXXXXX