XXXXXXXpXXXXXXX
XX X       XX X
XX XX  X  X   X
XX X     XX  XX
XXXXXXX pXX XXX
XXXXXXX      XX
XXXXXXX      XX
XXXXXX  X    XX
XXXXXXX  XXX XX
XXXXXXXX     XX
XXXXXXXXXX   XX
XXXXXXXXXXX XXX
XXXXXXXXXXX  XX
XXXXXXXXXXXXXXX
XXXXXXXXXXXXXXX