XXXXXXXXXXXXXXXXXXXXXX
XXXXXXXXXXXXXXXXXXXXXX
XXXXXXXXXXXXXXXXXXXXXX
XXXXXXX    XXXXXXXXXXX
XXXXXXX  p XXXXXXXXXXX
XXXXXXXXX XXXXXXXXXXXX
XXXXXXXXX XXXXXXXXXXXX
XXXXX     XXXXXXXXXXXX
XXXXX  p  XXXXXXXXXXXX
XXXXX    DXXXXXXXXXXXX
XXXXX     XXXXXXXXXXXX
XXXXX     XX   XXXXXXX
XXXXXXX X XX   XXXXXXX
XXXX           XXXXXXX
XXXX       X   XXXXXXX
XXXX             XXXXX
XXXX       p  XX XXXXX
XXXX  p   XXXXp p  XXX
XXXXXXXXXD   D     XXX
XXXXXXXXXXXXXX     XXX
XXXXXXXXXXXXXXXXXXXXXX
XXXXXXXXXXXXXXXXXXXXXX