 XXXXXXX
XXXXXXX 
XXXXXX  
XXXXXX X
XXXX    
XX X  XX
XX     X
XX XX   