XXXXXXXXXXXXXXXXXXX
XXXXXXXXXXXXXXXXXXX
XXXXXXXXXXXXX   XXX
XXXXX           XXX
XX    XXXXXXX   XXX
XX      XXXXXX XXXX
XXXX    XXXXXX XXXX
XXXXp    XXXXX XXXX
XXXX     XXXXX XXXX
XXXX XX  XXXXX XXXX
XXXX XX  X     XXXX
XXX      X    XXXXX
XXX      XXXXXXXXXX
XXX         XXXXXXX
XX  p  p    XXXXXXX
XX          XXXXXXX
XXXXXX      XXXXXXX
XXXXXXXXXXXXXXXXXXX
XXXXXXXXXXXXXXXXXXX