XXXXXXXXXXXXXX
XXXXXXXXXXXXXX
XXXXXXXXXXXXXX
XX  XXX  XXXXX
XX       XXXXX
XX  XXX  XXXXX
XXX   X  XXXXX
XXXD     XXXXX
XXXX  X  XXXXX
XXX   XX XXXXX
XXX       XXXX
XXXX     pXXXX
XXXXXXXXXXXXXX
XXXXXXXXXXXXXX