XXXXXXXXXXXXXXXXXXX
XXXXXXXXXXXXXXXXXXX
XXXXXXXXXXXXXXXXXXX
XXXXXXXXXXXXXXXXXXX
XXXXX    XXXXXXXXXX
XXXXX     XXXXXXXXX
XXXXXXX X XXXXXXXXX
XXXXXXX X XXXXXXXXX
XX   XX X XX    XXX
XX              XXX
XXX    X   XXXXXXXX
XXX  XXXp  XXXXXXXX
XXX  XXX   XXXXXXXX
XXX XXXX  pXXXXXXXX
XXX XX     XXXXXXXX
XXX       pXXXXXXXX
XXXXXXXXXXXXXXXXXXX
XXXXXXXXXXXXXXXXXXX
XXXXXXXXXXXXXXXXXXX