XXXXXXXXXXX
XXXXXXXXXXX
XXXXXXX  XX
XX       XX
XX pXXXX XX
XXp XX   XX
X    X  XXX
X       XXX
X    D  XXX
XXXXXXXXXXX
XXXXXXXXXXX