XXXXXXXXXXXXXXXXX
XXXXXXXXXXXXXXXXX
XXXXXXXXXXXXXXXXX
XXXXX  XXXXXXXXXX
XXXXX       XXXXX
XXXXX  XXXX XXXXX
XX     XXXX XXXXX
X  p         XXXX
X      XXX   XXXX
X    X XXXX XXXXX
XXX    XXXX XXXXX
XXX    XXX   XXXX
XXX          XXXX
XXX          XXXX
XXXXXXXXXXXXXXXXX
XXXXXXXXXXXXXXXXX
XXXXXXXXXXXXXXXXX