XXXXXXXXXXXXX
XXXX  XXXXXXX
XXXXX XD XXXX
XXXXX       X
XXX X XXXXX  
XXX   XXXXXXX
XXXX XXXXXXXX
XXXXXXXXX    
XXXXXXXX  XXX
XXXXX        
XXXXXX XXXX  
XXXXXX XX    
XXXXXXXXX   X