XXXXXXXXXXXXXXX
XXXXXXXXXXXXXXX
XXXXXXXXXXXXXXX
XXXXXXXXXXXXXXX
XXXXXp XXXXXXXX
XXXXX  XXXXXXXX
XXXXX  XXXXXXXX
XXXXXX XXXXXXXX
XXXXXX XXXX  XX
XXX          XX
XXX        p XX
XXX      XX  XX
XXXXXXXXXXX  XX
XXXXXXXXXXXXXXX
XXXXXXXXXXXXXXX