XXXXXXXXXXXX
XXXXXXXXXXXX
XXXXXXX XXXX
XXXXXX   X  
XXXXXX   XX 
XXXXXX  XXX 
 X     D  X 
X  XXXXXX XX
XXXXXXXX pXX
XXXXXXXX XXX
XXXXXXXX XXX
XXXXXX   XXX