XXXXXXXXXXXXX
XXX p XXX  XX
XXXXXXXXX    
XXXXXXXXX  X 
XXXXXXXX  XXX
XXXXXXXX DXXX
XXXXXXX   XXX
XXXXXXD    X 
XXXXXX XXX   
XX XX    XX X
XX       pp  
XXX XX       
XXXXXXXXXX   