XXXXXXXXX
XXXXXXXXX
XXXXXXXXX
XX pXXXXX
XX  XXXXX
XX  X  XX
XX     XX
XXXXXXXXX
XXXXXXXXX