XXXXXXX 
XXXX XXX
XXX  XXX
XXX  XXX
XXXXXXXX
 XXXXXXX
XXXXXXX 
XXXXXXXp