XXXXXXXXXX
XXXXXXXXXX
XXXXXXXXXX
X  XXXXXXX
X     XXXX
XX  X XXXX
XX    XXXX
XXXX  XXXX
XXXXXXXXXX
XXXXXXXXXX