XXXXXXXX
XXXXXXXX
X  X  XX
X    pXX
X   X XX
X    XXX
XXXXXXXX
XXXXXXXX