XXXXXXXXXX
 XXXXXX  X
 XXX XXX X
XXX    X X
XXX XXXX X
XXX XXXX  
XXX XXXX  
XX DXX    
XX XXX  D 
X  XXXX  X