XXXXXXXXXXXXXXXXXXXXX
XXXXXX    XXXXXXXXXXX
XXXXXX    XX      XXX
XXXXXX    XX      XXX
XXXXX      D      XXX
XXXXX XX XXX      XXX
XXXXX XXDXXX      XXX
X        XXXXXX XXXXX
X        XXXXXX XXXXX
XX p     XXXXXX XXXXX
XX       XXXXXX XXXXX
XX       XXXXXX XXXXX
XX             XXXXXX
XX         XXXXXXXXXX
XX         XXXXXXXXXX
XX     XXXXXXXXXXXXXX
XXX    XXXXXXXXXXXXXX
XXX  p XXXXXXXXXXXXXX
XXX    XXXXXXXXXXXXXX
XXXXXXXXXXXXXXXXXXXXX
XXXXXXXXXXXXXXXXXXXXX