XXXXXXXX
X  XXXXX
X  XXXXX
XXDXXXXX
X    XXX
X    XXX
XXXXXXXX
XXXXXXXX