XXXXXXXXXX
XXXXX XXXX
XXXXX    X
XXXXX  X X
XXXXD  X  
XXXXX  X  
XXX X  XD 
XX        
X     XX D
X     XX  