XXXXXXXXXXXXXXXXX
XX   XXXXXXXXXXXX
XX    D       XXX
XX   XXXXXXXX XXX
XXX XXXXXXXXX XXX
XXX XXXXX  XX XXX
XXX        XX XXX
XX   XXXX  XX XXX
XX      XX XX XXX
XX      XXDXX XXX
XX      XX X   XX
XX             XX
XXXp      XX   XX
XXX    XXXXXXXXXX
XXXXXXXXXXXXXXXXX
XXXXXXXXXXXXXXXXX
XXXXXXXXXXXXXXXXX