XXXXXXXXXXXXXXXXXXXXXX
XXXXXXXXXXXXXXXXXXXXXX
XXXXXXXXXXXXXXXXXXXXXX
XXXXXXXXXXXXXXXXXXXXXX
XXXXXXXXXXXXXXp     XX
XXXXXXXXXXXXXX      XX
XXXXXXXXXXXXXX      XX
XXXX                XX
XXXX    XXXXXX      XX
XXXX      XXXX      XX
XXXX    X XXXXXXX XXXX
XXXXX   X XXXXXXXDXXXX
XX      X XXXXXXX XXXX
XX      X XXXXXXXDXXXX
XX      X XXXXXXX XXXX
XX             DDXXXXX
XX            XXXXXXXX
XX            XXXXXXXX
XXXX   p      XXXXXXXX
XXXX     p XXXXXXXXXXX
XXXXXXXXXXXXXXXXXXXXXX
XXXXXXXXXXXXXXXXXXXXXX