XXXXXXXXXXXXXXXXX
X X          X XX
X XXXXXX    XX   
X  XXXXX    XXX X
X     XX X   XX X
XXXXX  X     XX X
XXXXXX XX  XXXX  
XXXXXX X    XXX X
XXXXXX X  X  XX  
XXXXXX X XXX     
XXXXXX XpXX  XX X
XXXXXX    XXXXX X
XXXXXXXp XXXXX  X
XXXXXXXX XXXXXXXX
XXXXXXXXXXXXXX   
XXXXXXXXXXXXXX  X
XXXXXXXXXXXXXXXXX