XXXXXXXXXXXX
XXXXXXXXXXXX
XX  XXXXXXXX
XX   XX  XXX
XX   XXppXXX
XXX  XX  XXX
XXX  XXX XXX
XX     X XXX
XX  p   XXXX
XXX   XXXXXX
XXXXXXXXXXXX
XXXXXXXXXXXX