XXXXXXXXXX
XXXXXXXXXX
X  XX  XXX
Xp     XXX
X  XX  XXX
X p    XXX
XXXXXXXXXX
XXXXXXXXXX
XXXXXXXXXX
XXXXXXXXXX