XXXXXXXXXXXXXXXXXX
XXXXXXXXXXXXXXXXXX
XXXXX  XX    XXXXX
XXXXX  XX    XXXXX
XXXXX        XXXXX
XXXXX  XX    XXXXX
XX      X    XXXXX
XX              XX
XX      X X XXX XX
XXX     X X XXXDXX
XXX         XX  XX
X    DD      D  XX
X           XXXXXX
X          pXXXXXX
XX          XXXXXX
XX   XXXXX  XXXXXX
XXXXXXXXXXXXXXXXXX
XXXXXXXXXXXXXXXXXX