XXXXXXXXXXXXXX
XXXX   XXXXXXX
XX     XXXXXXX
XX X   XXXXXXX
X   X XXXXXXXX
X    XXXXXXXXX
X          XXX
XX XXXXXX   XX
XX XXXXXX   XX
XX XX   XXXXXX
XX XX   XXXXXX
XX      XXXXXX
XXXXXXXXXXXXXX
XXXXXXXXXXXXXX