XXXXXXXXXX
X        X
XXX   X XX
X   XXXXXX
X  XXXXXXX
      DXXX
XXXXX   XX
XXXXXX XXX
XXXXXXXXXX
XXXXXXXXXX