XXXXXXXXXXXXXXX
XXXXXXXXXXXXXXX
XXXXXXXXXXXXXXX
XXXXXXXXXX    X
XXXXXXXXXX XXXX
XXXXXXXXXX XXXX
XXXXXXXX   XX X
XXXXXXX        
XXXXXX  XX XXX 
XXXXXX XXX XXXX
XXXXXX XXX  XXX
XXXXXX XX   XXX
XXXXX   XXXD XX
XXXXX   XXX  XX
XXXXX  XXXX   X