XXXXXXXXX XXXX XXXXXXX
XXXXXXX XXXXXXXXXXXXXX
XXXXXX  XXXXXXXXXXXXXX
XXXXXXX XXXXXXXXXXXXXX
XXXXXXXXXXX X XXXXXX  
XXXXXXXXXXX   XXXXXX  
XXXXXXXXXXXXX     X   
XXXXXXXXXXXXXXXXX     
XXXXXXXXXXXXXXXXXXX  X
XXXXXXXXXXXXXXXX X   X
XXXXXXXXXXXXXX   X   X
XXXXXXXXXXXXX    X X  
XXXXX  XXXXXX X    XXX
XXX X  X DD   X   XXXX
XXX      X    X  XXXXX
XXXXXX  XXX    D XXXXX
XX           XXXD XXXX
X p    XpD        XXXX
XXXXXXXXX    XXX      
XXXXXXX D  X   X      
XXXXXX  X    X X XX   
XXXXXX  X  X        X 