XXXXXXXXXXXXXXXXXXXX
XXXX  XXXX  X   XXX 
XXX   XXXXXXX  XXXX 
XX  X  XXXXXX  XXXX 
XX XX XXXXXXX       
XX XX  XXXXXX  p    
XXXXXX XXXXXX   XXX 
XXXXXX XXXX   X  XX 
XXXXXXpXXXXXX XX    
XXXXXXpXXXXXX XXXX  
XXXX   XXXX   XXX   
XXXXXXXXXXX  XXXXXXX
 XXXXXXXXXXX XXXXXXX
XXXXXXXXXXXXXXXXXXXX
XXXXXXXXXXXXXXXXXXXX
XXXXXXXXXXXXXXXXXXXX
XXXXXXXXXXXXXXXXXXXX
XXXXXXXXXXXXXXXXXXXX
XXXXXXXXXXXXXXXXXXXX
XXXXXXXXXXXXXXXXXXXX