XXXXXXXXXXXXXXXXXXXXXXXX
XXXXXXXXXXXXXXXXXXXXXXXX
XXXXXXXXXXXXXXXXXXXXXXXX
XXXXXXXXXXX     XXXXXXXX
XX        D     XXXXXXXX
XX      XXXXX XXXXXXXXXX
X       XXXXX XXXXXXXXXX
X                   XXXX
XX      XXXXX XXXXX XXXX
XX      XXXXX XXXXX XXXX
XX X   XX  XX XXXXX XXXX
XX X       XX XXXXX XXXX
XX X   XXX XX XXXXX XXXX
XX       X XX XXXX   XXX
XX            XXXX   XXX
XX                   XXX
XX               X   XXX
XX        X X XXXX XXXXX
XX        XDX X       XX
XX        p           XX
XX                    XX
XXXXXXXXXXXXXXXXXXXXXXXX
XXXXXXXXXXXXXXXXXXXXXXXX
XXXXXXXXXXXXXXXXXXXXXXXX