DD    XX
XXXX  XX
XX    XX
X pX pXX
X  X  XX
XXXXXXXX
XXXXXXXX
XXXXXXXX