XXXXXXXXXXXXXX
XXXXD    XXXXX
XXX  XXXXXXXXX
XXX XXXXXXXXXX
XXXXXXXXXXXXXX
XXXXX XXXXX XX
XXXXX   X X   
XX        D   
XX XXXX       
X  X          
XXXXXXX    X  
XXXXXX  XXD  D
XXXXXXXXXXX   
XXXXXXXX      