XXXXXXXXXXXXXXXXXXXXXXXX
XXX   XXXXXXXXXXXXXXXXXX
XX    XXXXXXXXXXXXXXXXXX
XXDX XXXXXXXXXXXXXXXXXXX
XX X XXXXXXXXXXXXXXXXXXX
XX X XXXXXXXXXXXXXXXXXXX
X    XXXXXXXXXXXXXXXXXXX
X     p      XXXXXXXXXXX
X                  XXXXX
XX           XXXXX XXXXX
XX     XX    XX       XX
XX    D      D        XX
XXX D                 XX
XXX           X       XX
X       p     XXXXX XXXX
X             XXXXX XXXX
X            XXXXX   XXX
Xp    p      XXXXX   XXX
X            D       XXX
X     p      XXXXX   XXX
XXXXX       pXXXXX   XXX
XXXXXXXXXXXXXXXXXXXXXXXX
XXXXXXXXXXXXXXXXXXXXXXXX
XXXXXXXXXXXXXXXXXXXXXXXX