XXXXXXXXX 
XXXXXXXXXX
XXXXXXXXXX
XXXXXXXXXX
X XXXXXX X
XXXXXXXX  
XXXXXXXXX 
XXXXXXXXXX
pXXXXXXXXX
X   XXXXXX