XXXXXXXXXXXXXXXX
XXXXXXXXXXXXXXXX
XXXXXXXXXXXXXXXX
XXXXXXXXXXXXXXXX
XX p XXXXX  XXXX
XX     DXX  XXXX
XX    X XX pXXXX
XX          XXXX
X     X XXXXXXXX
X        XXXXXXX
X          XXXXX
X     p   pXXXXX
X       XXXXXXXX
X       XXXXXXXX
XXXXXXXXXXXXXXXX
XXXXXXXXXXXXXXXX