XXXXXXXXXXXXXXXXXXXX
XXXXXXXXXXXXXXXXXXXX
XXXXXXXXXXXXXXXXXXXX
XXXXX   XXXXXXXXXXXX
X  XX            XXX
X  XXX XXX   XXX XXX
X p          XXX XXX
X      X X   XXX XXX
X      X XX XXXX XXX
XX     X XX XXXX XXX
XX   DXX XX XXXX XXX
XX    XX XX   XX XXX
XX    X   X   X   XX
XX    X      XX   XX
XX                XX
XXX    XX    XX   XX
XXXXXXXXX    XX   XX
XXXXXXXXX    XXXXXXX
XXXXXXXXXXXXXXXXXXXX
XXXXXXXXXXXXXXXXXXXX