XXXXXXXXXXXXXXXXXXXXX
XD XX   pX  XX       
XX XX X    XX   X   X
XX X  X XX XX  XX  XX
XX X XX    X  pXX XXX
X  X XX X    XX   XXX
X     X XX XXXX X XXX
X X                  
X        D  XXXXpXXXD
XX X Xp   X XXXX XXX 
XX X X    X  XXX XXX 
XX       XXX XXXD    
XXX X X XXXXpXXXXX XX
XXX   X   XX  XXXX XX
XXXX  XXX    XXXXX XX
XXX     XX   XXXXXXXX
XXX XXp XXXX XXXXXXXX
XX  XX XXXXX XXXXXXXX
XX  X  XXXXX XXXXXXXX
XXXXXXXXXXXX XXXXXXXX
XXXXXXXXXXXX XXXXXXXX