XXXXXXX XXXXXXXXXXXXXXXX
XXXXXXX XXXXXXXXXXXXXXXp
XXXXXXX XXXXXXXXXXXXXXXX
XXXXXXX XXXXXXXXXXXXXXXX
XXXXXXX XXXXXXX XXXXXXXX
XXXXXXX XXXXXXX XXXXXXXX
XXXXXXX   XXXXX  X   XXX
XXXXXXXXX XXXX   X  XXXX
XXXXXXXXX  XXX  XX  XXXX
XXXXXXXXXD XXX  XX XXXXX
XXXXXXXXX   XX  XX   XXX
XXXX  XX       XXXXX XXX
XXXXD X  X     XXXXX  XX
XXXX  X X     XXXXXXX XX
XXXX    X   X XXXXXX   X
Xp     D   X  XXXXXXXX  
XXXX D X XD  XXXXXXXX   
XXXX     X   XXXXXXXX X 
XXXX  X  XX   XXXXXXX X 
XXXX    XXX    XXXXXX X 
XXXX     XX pX XXXXXX   
XXXX X X XX  X XXXXX    
XXXX XDX XX  XpXXXXX  XX
XXXX X X  D  pDXXX    XX