XXXXXXXXXXXXXXXX
XXXX  XXXXXXXXXX
XXXX    D  DXXXX
X   p XXXXX XXXX
X     XXXXXDXXXX
X     XXXXX XXXX
X      XXXX XXXX
X      XX    XXX
X  X   XX    XXX
XX     XX    XXX
XX    p   XXXXXX
XX   XXXX XXXXXX
XX   XX    XXXXX
XX         XXXXX
XXXXXXXXXXXXXXXX
XXXXXXXXXXXXXXXX