XXXXXX XXXXXXX
XXXXXXXX XXXXX
XXXXXXX  XXXXX
XXXXXXX XXXXXX
XX   XX XXXXXX
XX XXX  XXXXXX
X  XXX  XXXXXX
  XXXXX XXpXXX
X XXXXX pX XXX
XXXXXXXX   XXX
XXXXXXXX   XXX
XXXXXXXX   XXX
XXXXXXX    XXX
XXXXX X    X X