XXXXXXXXXXXXXXXXXXXXX
XXXXXXXXXXXXXXXXXXXXX
XXXXXXXXXXXXXXXXXXXXX
XXXXX  XXXXXXXXXXXXXX
X   X            XXXX
X   XX XXXXXXX     XX
X         XXXX     XX
X   XX XX X        XX
X   XX XX   XX     XX
XX XX   X      D XXXX
XX      X   XXXX XXXX
XX      X   XXXX XXXX
X       X   XXXXDXXXX
X       p    XXX XXXX
Xp           XXX XXXX
X            XXX XXXX
X            X    XXX
X                 XXX
XXXXX       XX    XXX
XXXXXXXXXXXXXXXXXXXXX
XXXXXXXXXXXXXXXXXXXXX