XXXXXXXXXXXXXXXXXXXXX
XXXXXXXXXXXXXXXXXXXXX
XXXXXXXXXXXXXXXXXXXXX
XXXXXXXXXXXXXXXXXXXXX
XXXXXX      XXXXXXXXX
X    X      XXXXXXXXX
X            XXXXXXXX
X  p X       X   XXXX
XXX XXXX         XXXX
XXX       XX X   XXXX
XXX       XX XXDXXXXX
XXX        X X  XXXXX
XXX   p         XXXXX
XX p            XXXXX
XX       XXX X  XXXXX
XX X   XX    X  XXXXX
X  X         XX XXXXX
X              XXXXXX
X     p X   pXXXXXXXX
XXXXXXXXXXXXXXXXXXXXX
XXXXXXXXXXXXXXXXXXXXX