XXXXXXXXXXXXXXXXXXX
XX    XXXXXXXXXXXXX
XX    XXXXXXXXXXXXX
XX         XXXXXXXX
XX    XXXX XXXXXXXX
X  p XXXXX XXXXXXXX
X    XXXXX XXXXXXXX
X       XX XXXXXXXX
X          XXXXXXXX
X          XXXX  XX
X          XXXX  XX
X    X  X        XX
X       XX XXXX  XX
X            XX  XX
X               XXX
XX           XXXXXX
XXX     XXXXXXXXXXX
XXXXXXXXXXXXXXXXXXX
XXXXXXXXXXXXXXXXXXX