XXXXXXXXXXXXXXXXXXXX
XXXXXXXXXXXXXXXXXXXX
XXXXXXXXXXXXXXXXXXXX
XXXXXXXXXXXXXXXXXXXX
XXX    XXXXXXXXXXXXX
XXX    XXXXXXXXXXXXX
XXX    XXXXXXXXXXXXX
XXXp   XXX   XXXXXXX
XXX    XXX   X   XXX
XXXX         X   XXX
XXXX           XXXXX
XXX        DD    XXX
X        XX XX    XX
X                 XX
X        D XXX    XX
X               XXXX
XX           X  XXXX
XXXXX  D        XXXX
XXXXXXXXXXXXXXXXXXXX
XXXXXXXXXXXXXXXXXXXX