XXXXXXXXXXXXXXXXXXXXX
XXXXXXXXXXXXXXXXXXXXX
XXXXXXXXXXXXXXXXXXXXX
XX   XXXXXXXXXXXXXXXX
XX   XXXXXXXXXXXXXXXX
XXX XXXXXXXXXXXXXXXXX
X   XXXXXXXXXXXXXXXXX
X   XXXXXXXXXXXXXXXXX
X          XXXXXXXXXX
X                XXXX
X       p  XX      XX
X        XXXX      XX
X                  XX
X         XXX      XX
X          XXp     XX
X          XXXXXXXXXX
X          XXXXXXXXXX
X           XXXXXXXXX
X           XXXXXXXXX
XXXXXXXXXXXXXXXXXXXXX
XXXXXXXXXXXXXXXXXXXXX