XXXXXXXXXXXXXXXX
XXXXXXXXXXXX  XX
XXXXXXXXXXXX X X
XXXXXXXXXXXX    
XXXXXXXXXXXX    
XXXXXXXX    D X 
XXXXXXXXXXXX    
XXXXXXXXXXX   pD
XXXXXXXXXX    X 
XXXXXXXXXX   X  
XXXXXXXXX  X    
XXX XX X  XXXXXX
XXX XX       X  
XXX     XXXX    
XXX  XXXXXXXXXXX
XXXXXXXXXXXXXXXX