XXXXXXXX
XXXXXXXX
XX  XXXX
XXp XXXX
X   XXXX
Xp  XXXX
XXXXXXXX
XXXXXXXX