XXXXXXXXXXXXXXXXX
XXXXXXXXXX    XXX
XX    XXXX    XXX
XX       D    XXX
XX     XXX    XXX
X    X   XXX XXXX
X        XXX XXXX
X           XXXXX
X     D     XXXXX
X    X  XXX XXXXX
X       XXX XXXXX
X p      X  XXXXX
X           XXXXX
XXXX     X  XXXXX
XXXXXXXXXXXXXXXXX
XXXXXXXXXXXXXXXXX
XXXXXXXXXXXXXXXXX