XXXXXXXXXX
XX  X  XXX
XX  D  XXX
XX   X  XX
XX      XX
XX   X XXX
XX    XXXX
XXXXXXXXXX
XXXXXXXXXX
XXXXXXXXXX