XXXXXXXXXXXXX
XXXXXXXXXXXXX
X  XXXXXXXXXX
X    XXXXXXXX
XXX  XXXXXXXX
XXX     XXXXX
XXX  XX XXXXX
X p     XXXXX
X       XXXXX
X       XXXXX
XXXX    XXXXX
XXXXXXXXXXXXX
XXXXXXXXXXXXX