XXXXXXXXXXX
XXXXXXXXXXX
XXXXXX  XXX
XXD     XXX
XX   XX XXX
X  X XX XXX
X    XX XXX
X       XXX
X      XXXX
XXXXXXXXXXX
XXXXXXXXXXX