XXXXXXXXXXXXXXXXX
XXXXXXXXXXXXXXXXX
XX  XXXXXXXXXXXXX
XX   XXXXXXXXXXXX
XX  DXXXXXXXXXXXX
XXX      XXXXXXXX
XXX      XX  XXXX
XXX        p XXXX
XX      XXX  XXXX
XX        XXDXXXX
XX          X  XX
X              XX
X       XX XXXXXX
X    X XX  XXXXXX
XXX  X     XXXXXX
XXXXXXXXXXXXXXXXX
XXXXXXXXXXXXXXXXX