XXXXXXXXXXXXXXXXXXXXXXXX
XXXXXXXXXXXXXXXXXXXXXXXX
XXXXXXXXXXXXXXXXXXXXXXXX
XXXXXXXXXXXXXXXXXXXXXXXX
X  XXX      XXXXXXXXXXXX
X  XXX      XXXXXXXXXXXX
X  XXX XX XXXXXXXXXXXXXX
X   XX XX XXXXX       XX
X   XX XX XXXXX       XX
X   X     XXXXX     p XX
X   X     XXXXX       XX
XX        XXXXX  p    XX
XX  p     XXXXX       XX
XX        XXXXXXXX XXXXX
XX        XXXXXXXX XXXXX
XX       p  XXXXXX XXXXX
XX                XXXXXX
XX          XXXXXXXXXXXX
XX              XXXXXXXX
XX          XXX XXXXXXXX
XX p  X XXXX       XXXXX
XX    X            XXXXX
XXXXXXXXXXXXXXXXXXXXXXXX
XXXXXXXXXXXXXXXXXXXXXXXX