XXXXXXXXXXXXXXXXXXXXXXXX
XXXXXXXXXXXXXXXXXXXXXXXX
X      XXXXXXXXXXXXXXXXX
X      XXXXXXXXXXXXXXXXX
X      XXXXXXXXXXXXXXXXX
X      XXXXXXXXXXXXXXXXX
XXX      XXXXXXXXXXXXXXX
XXX      XXXXXXXXXXXXXXX
XXX      XXXXXXXXXXXXXXX
XXX      XXXXXXXXXXXXXXX
XXX      XXXX     XXXXXX
XXX      XXXX     XXXXXX
XXXXXX XXX     p  XXXXXX
XXXXX      pX     XXXXXX
XXXXX       X     XXXXXX
XXXXX       XXX XXXXXXXX
XX          XXX XX   XXX
XX          XXX XX   XXX
XX       p   XX      XXX
XX                   XXX
XX        XXXXXXXX   XXX
XX      XXXXXXXXXXXXXXXX
XXXXXXXXXXXXXXXXXXXXXXXX
XXXXXXXXXXXXXXXXXXXXXXXX