XXXXXXXXXXXXXX
XXXX X        
XXXX      X   
XXXXX      XX 
XXXXXX XXX  XX
XXXXX  XXXX p 
X  X  XXXXXXXX
XX    XXXXXXXX
XXXXXXXXXXXXXX
XXXXXXXXXXXXXX
XXXXXXXXXXXX  
XXXX      XX X
XXX       XX X
  XXX   X    X