XXXXXXXXXX
XXXXXXXXXX
XXXXXXXXXX
X  XXXXXXX
X       XX
X  XXX  XX
X  XXX  XX
X  XXXXXXX
XXXXXXXXXX
XXXXXXXXXX