XXXXXXXXXXXX
XXXXXXXXXXXX
XX  XXXX  XX
XX    D   XX
XX XXXXXX XX
X   X  XX XX
X        XXX
X      XXXXX
X    X XXXXX
X     XXXXXX
XXXXXXXXXXXX
XXXXXXXXXXXX