XXXXXXXXXXXX
XXXXXXXXXXXX
X p XXXXXXXX
X   XXXXXXXX
XX p XXXXXXX
X    XXXXXXX
X   p D  XXX
X   pXX  XXX
X        XXX
X     XXXXXX
XXXXXXXXXXXX
XXXXXXXXXXXX