XXXXXXXXXXXXXXXXXX
XXXXXXXXXXXXXXXXXX
XXXXXXXXXXXXXXXXXX
XXXXXXXXXXXXXXXXXX
XX   XXXXXXXXXXXXX
XX   XXXXXXXXXXXXX
XX     D  XXXXXXXX
XX   XXXX XX    XX
XX      p XX    XX
X         XX    XX
X             XXXX
X         XXX p XX
X               XX
X           X   XX
X    p      XXXXXX
X     D    XXXXXXX
XXXXXXXXXXXXXXXXXX
XXXXXXXXXXXXXXXXXX