XXXXXXXXXX
XXXXX  XXX
X  D   XXX
X  XXXDXXX
X  XXX XXX
X   XX  XX
X       XX
XXp   XXXX
XXXXXXXXXX
XXXXXXXXXX