XXXXXXXXXXXX
XXXXXXXXXXXX
XXXXXXXXXXXX
XX   XXXXXXX
XX        XX
XX  XXXXX XX
XX     XX XX
XXX    X  XX
XXXXXXXX  XX
XXXXXXXXXXXX
XXXXXXXXXXXX
XXXXXXXXXXXX