XXXXXXXXXXXXXX
XXXXXXXXXXXXXX
XXXXXXXXXXXXXX
XX   XXXXXXXXX
XX p XXX   XXX
X    XXX   XXX
X    XXXX XXXX
X      XX XXXX
X           XX
X           XX
X        XXXXX
X      XXXXXXX
XXXXXXXXXXXXXX
XXXXXXXXXXXXXX