XXXXXXXXXXXXXX
XX  XXXX    XX
X   XXXXXX  XX
X     XXXX  XX
X   XXXXXXX XX
X  XXXXXXXX XX
X   XXXXX   XX
XX   XXXXXXXXX
XX X  XXXXXXXX
XX XX XXXXXXXX
XX  X   XXXXXX
X  XXDp XXXXXX
XXXXXXXXXXXXXX
XXXXXXXXXXXXXX