XXXXXXXXXXXXXXXXX
XXXXXXXXXXXXXXXXX
X  p XXXXXXXXXXXX
X  p XXXXXXXXXXXX
XXX XXX  XXXXXXXX
XX  XXX  XXXXXXXX
XX    D  XXXXXXXX
XX  XXX  XXXXXXXX
XXX XXXX XXXXXXXX
XXX XXXX XXXXXXXX
XXX XXXX XXXXXXXX
XXX XXXX XXXXXXXX
XXX XX    XXXXXXX
XXX       XXXXXXX
XXXXXX    XXXXXXX
XXXXXXXXXXXXXXXXX
XXXXXXXXXXXXXXXXX