XXXXXXXXXXXXXXXXXXXX
XXXXXXXXXXXXXXXXXXXX
XXXXXXXXXXXXXXXXXXXX
XXXXXXXXXX    XXXXXX
XXXXXXXXXX       XXX
XXXXX    XXX XXX XXX
XXXXX p  XXX XXX XXX
XXXXXXX XXXX XXX XXX
XXXXXXX XXXX XXX XXX
XXXXXXX XXXX XXX XXX
X    Xp   XX XX   XX
X   p     XX      XX
X         XXDXX   XX
XX   p  DXX   XXXXXX
XX       D    XXXXXX
XX          XXX pXXX
XX               XXX
XX     XXXXXXXXXXXXX
XXXXXXXXXXXXXXXXXXXX
XXXXXXXXXXXXXXXXXXXX