XXXXXXXXXXXXXXXXXX
XXXXXXXXXXXXXXXXXX
XXXXXXXXXXXXXXXXXX
XXXX  XXXXXXXXXXXX
XXX   XXXXXXXXXXXX
XXX X XXXXXXXXXXXX
X     XXXX    XXXX
X       XX    XXXX
X        X    XXXX
XX       X    XXXX
XX            XXXX
XX       XXXXXXXXX
XX         XXXXXXX
X            XXXXX
X            XXXXX
X      XXXXXXXXXXX
XXXXXXXXXXXXXXXXXX
XXXXXXXXXXXXXXXXXX