XXXXXXXX
XXX  XXX
XXX  XXX
XXXX XXX
X  X XXX
X   XXXX
XXXXXXXX
XXXXXXXX