XXXXXXXXXXXXX
XXXX   XXXXXX
X  X   XXXXXX
X    p   DXXX
XX    XXX XXX
XX p  XXX XXX
X     XXX XXX
X     XX  XXX
X  p      XXX
X     XX  XXX
X  XXXXXXXXXX
XXXXXXXXXXXXX
XXXXXXXXXXXXX