XXXXXXXXXXXXXXXXXXXXXX
XXXXXXXXXXXXXXXXXXXXXX
XXXXXX    XXXXXXXXXXXX
XXXXXX    XXXXXXXXXXXX
XXXXXX    XXXXXXXXXXXX
XXXXXX            XXXX
XXXXXX    XXXXXXX XXXX
XXXXXX    XXXXXXX XXXX
XXXXXXXX XXXXXXXX XXXX
XXXXXXXX XXXXX      XX
XXX   XX XXXXX      XX
XXX   X      X      XX
X    p       X   p  XX
X     p             XX
X    p       XXXXX XXX
XX         XXp  XX XXX
XX         XX   XX XXX
XX              XX XXX
XX         XX   X  XXX
XXXX      XXX      XXX
XXXXXXXXXXXXXXXXXXXXXX
XXXXXXXXXXXXXXXXXXXXXX