XXXXXXXXXXXXXXXXXXX
XXXXXXXXXXXX     XX
XXXXXXXXXXXX     XX
XXXX   XXXXX     XX
XXXX   XXXXX     XX
XXXX   XXXXX     XX
XXXXX XXXXXXXX XXXX
XXXXX XXXXXXXX XXXX
XXXXX XXXXXXXX XXXX
XXXXX XXXXXXX  XXXX
XXXX           XXXX
XXX     XXXXX  XXXX
XXX           XXXXX
XX      XXXXXXXXXXX
XX     XXXXXXXXXXXX
XX     XXXXXXXXXXXX
XXXXXXXXXXXXXXXXXXX
XXXXXXXXXXXXXXXXXXX
XXXXXXXXXXXXXXXXXXX