XXXXXXXXXXXXXXXXXXX
XD XX   pXXXDXXXXXX
XX XX  X     XXXX  
XX XXX    X   XXX X
XX XXX   XXXXDXXX  
XXD XXX    X  XXXX 
XXX XXX    XXXXXXX 
X    XXXX    XXXX  
X    XXXX XXpXXXX X
X   XXXXX XX XXX  X
XX pXXXXXXXX     XX
X   XXXXXXXXXX  XXX
X    XXXXXX     XXX
X X XXXXXXX XXXXXXX
X    XXXXXX XXXXXXX
XXX XXXXXXXXXXXXXXX
X XXXXXXXXXXXXXXXXX
XXXXXXXXXXXXXXXXXXX
XXXXXXXXXXXXXXXXXXX