XXXXXXXXXXXXXXXXX
XXXXXXXXXXXXXXXXX
XXXXXXXXXXXXX  XX
XXXXXXXXXXXXX  XX
XX  XXXXXXXXXX XX
XX      XXXXXX XX
XX  XXX XXXXXX XX
XXX XXX X   XX XX
XX          XX XX
XX        XXXX XX
XX   X  XXXXXX XX
XXX       D  DXXX
XXX  p   XXXXXXXX
XXX      XXXXXXXX
XXX    XXXXXXXXXX
XXXXXXXXXXXXXXXXX
XXXXXXXXXXXXXXXXX