XXXXXXXXX
X  XXXXXX
X   D  XX
XX X   XX
X    X XX
X     XXX
X  XXXXXX
XXXXXXXXX
XXXXXXXXX