XXXXXXXXXXXXXXXXXXXX
XXXXXXXXXXXXXXXXXXXX
XXXXXXXXXXXXXXX    X
XXXXXXXXXXXXXX  XXXX
XXXXXXXXXXXXXX  XXXX
XXXXXXXXX XXXXX XXXX
XXXXXXX   XXXXX XXXX
XXXXXX  XXXXXX  XXXX
XXXXXX XXXXXXX   XXX
XXXXX  XXXXXXXXXpXXX
XXXXX  XXXXXXXXX    
XXXD   XXXXXXXXX XXX
XXX    XXXXXXXXX  XX
XX   XXXXXXXXXXXX XX
XX   XX    XXXXX  XX
X   XXXXXX   XX     
X Xp XXX     XX X   
X  X XXX XXX XX   XX
XXXX XXX  X  XX    X
XXXX X XX       Xp X