XXXXXXXX X
XXXXXXXXXX
XXXXXXXXXX
XXXXXXXXXX
X  XXXXX X
X  XXXXX  
XX XXXXXXD
XX XXXXX  
XX  XXXXX 
XX  XXXXXX