XXXXXXXXXX
XXXXXXXXXX
X pXXXXXXX
X   D DXXX
XX  XX XXX
X pp X XXX
X      XXX
X      XXX
XXXXXXXXXX
XXXXXXXXXX