XXXXXXXXXX
XX  XXXXXX
XX  XXXXXX
XXX  XXXXX
XXX     XX
X       XX
X     XXXX
XXXX  XXXX
XXXXXXXXXX
XXXXXXXXXX