XXXXXXXXXXXXXXXXXXXXXXX
XXXXXXXXXXXXXXXXXXXXXXX
XXXXXXXXXXXXXXXXXXXXXXX
X XXXXXXXXXXXXXXXXXXXXX
 XXXXXXXXXXXXXXXXXXXXXX
XXXXXXXXXXXXXXXXXXXXXXX
XXXXXXXXXXXXXXXXXXXXXXX
XXXXXXXXXXXXXXXXXXXXXXX
XXXXXXXXXXXXXXXXXXXXXXX
 XXXXXXXXXXXXXXXXXXXXXX
XXXXXXXXXXXXXXXXXXXXXXX
XXXXXXXXXXXXX XXXXXXXXX
XXXXXXXXXXXXX XXXXXXXXX
XXXXXXXXXXXXXDXXXXXXXXX
XXXXXXXX XXX  XXXXXXXXX
XXXXXXXXD X DX  XXXXXXX
XXXXXXXX       XXXXXXXX
XXXXXXXX X    XXXXXXXXX
XXXXXXXX XXX   XXXXXXXX
XXXXXXXX        XXXXXXX
XXXXXXXXX  X    XXXXXXX
XXXXX XX  p  X  XXXX  X
XXXXX XXX       XXX  XX