XXXXXXXXXXXXXX
XXXXXXXXXXXXXX
XXXXXXXXXXXXXX
XXX   XXXXXXXX
XXX   XXXXXXXX
XXXX pXXXXXXXX
XXXX        XX
XXXXp     X XX
XXXX   XX   XX
X   p       XX
X        X  XX
XXX    XXXXXXX
XXXXXXXXXXXXXX
XXXXXXXXXXXXXX