XXXXXXXXXXXXXXXX
X    XXXXXXXXXXX
X     XXXXXX  XX
X p   XXXXXX  XX
XXX X X       XX
XXX X X  XXX  XX
XXX X Xp XXXXXXX
XXX X XX XXXXXXX
XXX    X XXXXXXX
XXXD     XXXXXXX
XXX   X   XXXXXX
XXX p   p XXXXXX
XXX   XXXXXXXXXX
XXXXXXXXXXXXXXXX
XXXXXXXXXXXXXXXX
XXXXXXXXXXXXXXXX