XXXXXXXXXXX
XXXXXXXXXXX
XXXXXXXXXXX
XX  XXXXXXX
XX   XXXXXX
XXX  XXXXXX
XXX  XXXXXX
XXX   XXXXX
XXX   XXXXX
XXXXXXXXXXX
XXXXXXXXXXX