XX  XXXX
XX XXXXX
 D XXXXX
X  XXXXX
X   XXXX
X p  XXX
X    XXX
XXX   XX