XXXXXXXXXXXXXXX
XXXXXXXXXX XXXX
XXXXXXXXXX XXXX
XXXXXXXXXX  XXX
XXXXXXD XXX XXX
X XXXX  XXX XXX
XXXXXXX   XD  X
XXXXXXXXX X  pX
XXXXXXXXX    XX
XXXXXXXXX  X XX
XXXXXXXXX    XX
XXXXXXXXX     X
XXXXXXXX     XX
 XXXXXXX     XX
XXXXXXX  X   XX