XXXXXXXXXX
X pXXXXXXX
X  XXXXXXX
XX  XXXXXX
XX  XXXXXX
XX    XXXX
X     XXXX
X   DXXXXX
XXXXXXXXXX
XXXXXXXXXX