 XXXXXXXXXXXXXXXX
XXXXXXXXXXXXXXXXX
XXXXXXXXXXXXXXXXX
XXXXXXXXXXXXXXXXX
XXXXXXXXXXXX XXXX
XXXXXXXXXXX  XXXX
XXXXXXXXXXX XXXXX
XXXXXXXXXX  XXXXX
XX DXXX     XXXXX
XXX  XXX  XXXXXXX
XXXX D X  XXXXXXX
XXXXX X  XXXXXXXX
XXXX  XD XXXXXXXX
XX   XX     XXXXX
XX    X  XXX XXXX
X        XX  XXXX
X    XXX XXX   XX