XXXXXXXXXXXXX
XXXXpXXXX XXX
 XXXpX   DX  
XXXX  XXX  X 
XXXXX XXX    
XXXXXXXXX   X
XXXXXXXXX  XX
XXXXXXXX   XX
X  XXXX  X XX
X  XXX   D  X
XXD     X  XX
XXXXXX XXXXXX
XXXXXXXXXXXXX