XXXXXXXXXXXXX
X XXX XX  XXX
  XXX XX  XXX
XXXXX X   XXX
XXXXX     X  
XXXXXX    XX 
XXXX   XX XX 
XXXX XDXXXXX 
XXXX  XXXXXXX
XXXX  XXXXXXX
XXXX XXXXXXXX
XXXXXXXXXXXXX
XXXXXXXXXXXXX