XXXXXXXXXXXXXXXXX
XXXXX   XXXXXXXXX
XXXXX   XXXXXXXXX
XXXXX   XXXXXXXXX
XXXXXX XXX    XXX
XXXXXX X      XXX
XXXX   X X    XXX
XXXX   D      XXX
XXXX     X    XXX
XXXXX    XXXXXXXX
XXXXXXDX XXXXXXXX
XXXXXXDXDXXXXXXXX
XXXXXX   XXXXXXXX
XXXXXX   XXXXXXXX
XXXXXXXXXXXXXXXXX
XXXXXXXXXXXXXXXXX
XXXXXXXXXXXXXXXXX