XXXXXXXXX
XXXXXXXXX
XXXXX  XX
XX     XX
XX  XX XX
X   XX XX
X     XXX
XXXXXXXXX
XXXXXXXXX