XXXXXXXXXXXXXXXXXX
XXXXXXXXXXXXXXXXXX
XXXXXXXXXXXXX   XX
XX          D   XX
XX    XXXXXXXp  XX
X  X  p XXXXXX XXX
X       XXXXXX XXX
X  X    XXXXXX XXX
X          XXX XXX
X          XXXDXXX
XX      XX XXX XXX
XX X        XX XXX
XXDX        XX XXX
XX       p    XXXX
XXXXX       XXXXXX
XXXXX  p  XXXXXXXX
XXXXXXXXXXXXXXXXXX
XXXXXXXXXXXXXXXXXX