XXXXXXXXXXXXXXX
XXXXXXXXXXXX   
X  X   XX     X
XX        XXX  
XXXXXXXXXXXXX  
 XXXXXXXXXXXX  
XXXXXXXXXXXX  X
XXXXXXXXXXXXXXX
XXXX     XXX XX
XXXXX XX  XX DD
XXXXXXXX  XXXXX
XXXXXXXXX XXXXX
XXXXXXXXX  X XX
XXXXXXXXXX    X
XXXXXXXXXXX X X