XXXXXXXXX
X  XXXXXX
X   DXXXX
X  X XXXX
Xp   XXXX
X    XXXX
X  XXXXXX
XXXXXXXXX
XXXXXXXXX