XXXXXXXX
XXXXXXXX
X  XXXXX
X  XXXXX
XXDX  XX
XX    XX
XXXXXXXX
XXXXXXXX