XXXXXXXXXXXXXXXXXXXXXX
XXXXXXXXXXXXXXXXXXXXXX
X  XXXXXXXXXXXXXXXXXXX
XX XXXXXXXXXXXXXXXXXXX
XX  XXXXXXX XXXXXXXXXX
XXX X XXXXX XXXXXXXXXX
XXX   XXXXX XXXXXXXXXX
X     XXXXX    XXXXXXX
X   X  XXXXX XXXXXXXXX
XX     XXXXX XXXX  XXX
XX    XXXXXX  XXX  XXX
X   XDXXXXXX   XX XXXX
X     XXXX   XXXX  XXX
X     XXXX XXXXXX  XXX
XXX    XXX XXX     XXX
Xpp      p         XXX
XXXX     X   X     XXX
X        D     X    XX
XXX  XX    XX XX X  DX
XXX  XX X XXX XX X D  
XXXp    X XXX    X    
XXXX    X  XXX      XX