XXXXXXXXXXX
X p XX  XXX
XX   X XXXX
XX X   XXXX
   p     XX
XX X  XXXXX
XXX  XXXXXX
XXXXXXXXXXX
XXXXXXXXXXX
XXXXXXXXXXX
XXXXXXXXXXX