XXXXXXXXXXXXXX
XXXXXXXXXXXXXX
XXXXXXXXXXX  X
XXXXXXXXXXX   
XXXXXXXXXXXX  
XXXXXXXXXXXX  
XXXXXXXXXXXX  
XXXXXXXXXXXX  
X XXXXXX D XXX
   D XXXXD    
XXXX DXXXX XX 
XXXX  X  X  XX
XXXXX    X    
XXXXX  X    p 