XXXXXXXXXXXXXXXXXXXXXXXX
XXXXXXXXXXXXXXXXXXXXXXXX
XXXXX    XXXXXXXXXXXXXXX
XXXXX       XXXXXXXXXXXX
XXXXX    XX XXXXXXXXXXXX
XXXXXXX XXX XXXXXXXXXXXX
XXXXXXX XXX XXXXXXXXXXXX
XXXXXXX XXX XXXXXXXXXXXX
XXXXXXX XXX XXXXXXXXXXXX
XXX       X XXXXXXXXXXXX
XXX       X XXXXXXXXXXXX
XXX       X XXXXXXXXXXXX
XX        X XXXXXXXXXXXX
XX        X XXXXXXXXXXXX
XXp       X XXXXXXXXXXXX
XX        p XXXXXXXXXXXX
XX                XXXXXX
X          XXXX     XXXX
X        XXXXXX     XXXX
X   XXXXXXXXXXX     XXXX
XXXXXXXXXXXXXXX     XXXX
XXXXXXXXXXXXXXXXXXXXXXXX
XXXXXXXXXXXXXXXXXXXXXXXX
XXXXXXXXXXXXXXXXXXXXXXXX