XXXXXXXXX
XXXXXXXXX
XXXXXXXXX
XX  XXXXX
XX  DXXXX
X    XXXX
X    XXXX
XXXXXXXXX
XXXXXXXXX