XXXXXXXXXXXXXXXXXXXXXX
XXXXXXXXXXXXXXXXXXXXXX
XXXXXXXXXXXXXXXXXXXXXX
XXXXXXXXXXXXXXXXXXXXXX
XXXXXX     pXXXXXXXXXX
X p XX      XXXXXXXXXX
X   XX XX XXXXXXXXXXXX
X   XX XX XXXXXXXXXXXX
X                XXXXX
Xp  XX XX XXXXXX XXXXX
X   X   X XXXXXX XXXXX
XX          XXXX XXXXX
X            XXX XXXXX
X            XXX XXXXX
X            X     XXX
X            X  p  XXX
X        pp  X     XXX
XX        X        XXX
XXXXXX             XXX
XXXXXX     XXXXXXXXXXX
XXXXXXXXXXXXXXXXXXXXXX
XXXXXXXXXXXXXXXXXXXXXX