XXXXXXXXXXXXXXXXXXXXXXXX
XXXXXXXXXX  XXXXXXXXXX  
XXXXXXXXXX    XXXXXXXXXX
XXX     XX XX   XXXX    
XXX  XX    XXX       XXX
XXX XXX XX XXXXX XXX XXX
XXX XXXXXXXXXXXXXXXXX XX
XXX XXXXXXXXXXXXXXXXX XX
XXX XXXXXXXXXXXXXXXXX XX
XXX XXXXX  XXXXXXXX  p  
XXX XXXX   XX X         
XXX XXXX X        XX    
XXX XXXXX              X
XXX XXX                X
XXX XX    XXX  XXX     X
XXX       XXXXXXXXXXX   
XXX XXX XXXXXXXXXXXXX XX
XXX XXXXXXXXXXXXXX  X XX
XXX XXXXXXXXXX      X XX
XXX XXXXXXXXXX pXXX     
XXX XXXXXXXXXXX XXXXX XX
XXX XXXXXXXXXXXXXXXXX XX
XXX XXXXXXXXXXXXXXXXX XX
XXX XXXXXXXXXXXXXXXXX XX