XXXXXXXXXXXXXXXXXX
XXXXXXXXXXXXXXXXXX
XXXXXXXXXXXXXXXXXX
XX     XXXXXXXXXXX
XXp    XXXXXXXXXXX
XX     XXXXXXXXXXX
XXXDXXXXXXXXXXXXXX
X    XXXXXX  pXXXX
X             XXXX
XXp  XXXXXXX XXXXX
XX        XX XXXXX
XX   p      XXXXXX
XX     XXXXXXXXXXX
XXD  XXXXXXXXXXXXX
X     XXXXXXXXXXXX
X     XXXXXXXXXXXX
XXXXXXXXXXXXXXXXXX
XXXXXXXXXXXXXXXXXX