XX XXXXXXXXXXX
X  XXXXXX    X
XX XXXXXX    X
XXDXXXXXXX    
XX  XXXXXXXX  
XXX  XXXXXXp  
XXX XXXXXX   X
XXX XXXXX p pX
XXXXXXXXX    X
XXXXXXXXXXX   
XXXXXXXXXXX X 
XXXXXXXXXXX   
XXXXXXXXXXX   
XXXXXXXXX    X