XXXXXXXXXXXXXXXXXX
XXXXXXXXXXXXXXXXXX
XXXXXXXXXXXXXXXXXX
XX    XXXXXXXXXXXX
XX    XXXXXXX   XX
XXXX  D         XX
XXXX XXXXXXXX   XX
XXXX XXXXXXXXX XXX
XXXX XXXXXXXXX XXX
X  X     pXXXX XXX
X         pXXXDXXX
X  X       XXX XXX
X          XXX XXX
X             XXXX
X     XXXXXXXXXXXX
X    XXXXXXXXXXXXX
XXXXXXXXXXXXXXXXXX
XXXXXXXXXXXXXXXXXX