XXXXXXXX
XXXXXXXX
XX  XXXX
XX pXXXX
X     XX
X p   XX
XXXXXXXX
XXXXXXXX