XXXXXXXXXXXXXXXXXXXX
XXXXXXXXXXXXXXXXXXXX
XXXXXXXXX  XXXXXXXXX
XXXXXXXXX  XXXXXXXXX
XXXXXXXXX  XXXX  XXX
XXXXXXXXX  XXXXppXXX
XXXXXXX  p       XXX
XXXXXXX XX    X  XXX
XXX     XX    X  XXX
XXX           XX XXX
XXX           XX XXX
XXX     XX p  XX XXX
XXXXXXX XXXX XXX XXX
XXXXXXX      XXX XXX
XXXXXXX      XXX XXX
XXXXX       D   XXXX
XXXXX p     XXXXXXXX
XXXXXXXX    XXXXXXXX
XXXXXXXXXXXXXXXXXXXX
XXXXXXXXXXXXXXXXXXXX