XXXXXXXXXXXXXXXXXXX
XXXXXXXXXXXXXXXXXXX
XXXXXXXXXXXXXXXXXXX
XXXXXXXXXXXXXXXXXXX
XXXXXXXXXXXXXXXX XX
XXXXXXXXXXX  XX  XX
XXXXXXXXXXXX XX XXX
XXXXXXXXXXXX XX  XX
XXXXXXXXXXX   XX  X
XXXXXXXXXXX X XX   
XXXXXXXXXXX X pX   
XXXXXpXXX XDX      
XXXXX XXX X XX     
XXXXX XXX X XX    p
XXXXX D   X  X   XX
XXXXX    XX DD     
XX XX  XXXXX  X XX 
XX  X   XXXX    XX 
XX X    XXXXp    XX