XXXXXXXXXXXXXXXXX
XXXXXXXXXXXXXXXXX
XXXXXXXXXXXXXXXXX
X  XXXXXXXXXXXXXX
X  XXXXXXXXXXXXXX
X   D       XXXXX
X  XXXX     XXXXX
XX XXXX     XXXXX
XX   XXXX    XXXX
XX   XX      XXXX
XX         XXXXXX
XX         XXXXXX
XXX         XXXXX
XXX         XXXXX
XXX         XXXXX
XXXXXXXXXXXXXXXXX
XXXXXXXXXXXXXXXXX