XXXXXXXXXXXXXXXXXXXXXXX
 XXXXXXXXX     XXXXXXXX
XXXXXXXXXXXXXXXXXXXXXX 
 XXXXXXXXXXXXXXXXXXXXX 
XXXXXXXXXXXXXXXXXXXXXXX
XXXXXXXXXXX XXXXXXXXXXX
XXXXXXXX    XXX XX     
XXXXXXXXX       XX XXX 
XXXXXXXXXXXXXXX    XXXX
XXXXXXXXXXXXXXXXXXX XX 
XXXXXXXXXXXXXX         
XXXXXXXXXXX  D    XXXXX
XXXXXXXXXX  XX     XXXX
       XX  XXXX     XXD
X         XXXXXXX X p  
        XXXXXXXXX XXX  
XXXXXXX XXXXXXXXXXXXXXX
XXXXXXX XXXXXXXXXXXXXXX
XXXXXXX   XXXX XXXXXXXX
XXXXXXXp  XXXX XXXXXXXX
XXXXXXXXX      XXXXXXXX
XXXXXXXXXX  XX XXXXXXXX
XXXXXXXXXXX XX XXXXXXXX