XXXXXXXXXXX
XXXXXXXXXXX
XXXXXXXXXXX
XXXXXXXXXXX
XXXXXXX  XX
XXXX  X  XX
XXXX  XX XX
XXX  XXX XX
XXX     XXX
XXXXXXXXXXX
XXXXXXXXXXX