XXXXXXXXXXXXXXXXXXXX
XXXXXXXXXX XXXXXXX X
XXXXXX     XXXXXXX X
XXXXXX      XXXX  DX
XXXXXX    XD     XXX
XXXXXX             X
XXX X  XXXXX        
XXX    XXXXXX  X    
XXXXXXXXX           
XXXXXXXXX  XX  XX   
XXXXXXXXX  X  XXX   
XXXXXXXXXX   XXXXX  
XXXXXXXXXX XXXXXXX  
XXXXXXX   XXX  X   X
XXXXXXXXX          X
XXXXXXXX  XX    X XX
XXXXXXX      X   XXX
XXXX p       X      
XX   XXX XX XXXX    
X   XXXXXXXXXX  XXX 