XXXXXXXXXX
XXXXXXXXXX
XXXXXXXXXX
XX  XX  XX
XX  D   XX
XX  XXX XX
X   XX  XX
X  XXX pXX
XXXXXXXXXX
XXXXXXXXXX