XXXXXXXXX
X  XXXXXX
X  X  XXX
X     XXX
X  XX  XX
Xp D   XX
X  D XXXX
XXXXXXXXX
XXXXXXXXX