XXXXXXXXXXXX
Xp X  XXXXXX
X       XXXX
X  XXXX XXXX
XX XXXX XXXX
XX XXXX XXXX
X   XXX XXXX
X   XX  XXXX
X       XXXX
XXXXXX  XXXX
XXXXXXXXXXXX
XXXXXXXXXXXX