XXXXXXXXXXXXXXXXXXXXX
XXXXXXXXXXXXXXXXXXXXX
XXXXXXXXX   XXXXXXXXX
XXXXXXXXX        XXXX
XXXXXXXXXX XXXXX XXXX
XXX    XX  XXXXX XXXX
XXX    XX  XXXXX XXXX
XXX    XX  XXp     XX
XXXXX XXX pXX      XX
XXXX  XXXX XX      XX
XXXp           p   XX
XXX      X XX      XX
XXX      X XX  XXXXXX
XXX         D  XXXXXX
XXX  p   XXXXXXXXXXXX
XXX      XXXXXXXXXXXX
XXXX   XXXXXXXXXXXXXX
XXXX   XXXXXXXXXXXXXX
XXXXXXXXXXXXXXXXXXXXX
XXXXXXXXXXXXXXXXXXXXX
XXXXXXXXXXXXXXXXXXXXX