XXXXXXXXXXXXXXXXXX
XXXXXXXXXXXXXXXXXX
XXXXXXXXXXXXXXXX  
XXXXXXXXXXXXXXXX X
D  XXXXXXXXXXXXX X
X  XXXXXXXXXXXXX X
XX  XXXXXXXXXXXX X
X   XXXXXXXXXXXX  
XX XXXXXXXXXXXXXX 
X  XXX  XXXXXXXXXX
X XXXXXDXXXXXXXXXX
XX  XXX XXXXXXXXXX
XX  XXX  XXXXXXXXX
XXX XXX  XXXXXXXXX
XXX XXX XXXXXX  XX
XXX XX  XXXXXXDXXX
    XX p XXXXp   X
XX  XX  XXXXXXXX X