XXXXXXXXXXXXXXXXXXX
XXXXXXXXXXXXXXXXXXX
XXXXXXXXXXXXXXXXXXX
XXXXXXXXXXXXXXXXXXX
XXXXXXXXXXXX    XXX
XXXXX          pXXX
XXXXX XXX   XX XXXX
XXX    XX     XXXXX
X      XXX XXXXXXXX
X      XXX XXXXXXXX
X             XXXXX
X  p   XXX XX XXXXX
XX  p    DXXX XXXXX
X  p     pXXX XXXXX
X         X    XXXX
X         D    XXXX
X  XXXXXXXX    XXXX
XXXXXXXXXXXXXXXXXXX
XXXXXXXXXXXXXXXXXXX