XXXXXXXXXXXXXXXX
XXXXXXXXXXXXXXXX
XXXXXXXXXXXXXXXX
XXX  XXXXXXXXXXX
XXX          XXX
XXXX X  XXXX XXX
XXXX X  XXXX XXX
X  X X  XXXX XXX
X   XX  XXXXDXXX
X   XXX XXXX XXX
XX pXXX  X    XX
XX       X    XX
XX            XX
XXXXXX   X    XX
XXXXXXXXXXXXXXXX
XXXXXXXXXXXXXXXX