XXXXXXXXX
XXXX  XXX
X  X  XXX
X  XXDXXX
X  XX XXX
X   XDXXX
X    XXXX
XXXXXXXXX
XXXXXXXXX