XXXXXXXXXXXXXXXX
XXXXXXXXXXXXXXXX
XXXXXXXXXXXXXXXX
X    X    XXXXXX
X    X    XX  XX
X      p      XX
X    XXX      XX
XXX XXXX  XX  XX
X    XXX  XXXXXX
X  p      XXXXXX
X          XXXXX
XXXXXXX    XXXXX
XXXXXXXXXXXXXXXX
XXXXXXXXXXXXXXXX
XXXXXXXXXXXXXXXX
XXXXXXXXXXXXXXXX