XXXXXXXXXXXXXXXXXXXX
XXXXXXXXXXXXXXXXXXXX
XXXXXXXXXXXXXXXXXXXX
XXXX   XXXXX   p XXX
XXXX       X     XXX
XX               XXX
XX XX XXXX X     XXX
XX XX XXXX XXX XXXXX
XX XX XXXX XXX XXXXX
XX XX XX     X XXXXX
XX XX XX      XXXXXX
XX XX XX     XXXXXXX
X  XX     XXXXXXXXXX
X  X      XXXXX  XXX
X  X             XXX
XXXX         XXX XXX
XXXX p          XXXX
XXXX           XXXXX
XXXXXXXXXXXXXXXXXXXX
XXXXXXXXXXXXXXXXXXXX