XXXXXXXXXXXXX
XXXXXXXXXXXXX
XXXX pXXXXXXX
X  X   D XXXX
X     XX XXXX
XX  X XX XXXX
XX    XX XXXX
X     X   XXX
X     X   XXX
XX p      XXX
XX     XXXXXX
XXXXXXXXXXXXX
XXXXXXXXXXXXX