XXXXXXXXXXXXXXXXXXXX
XXXXXXXXXXXXXXXXXXXX
XXXXXX     XXXXXXXXX
XXXXXX        XXXXXX
XXXXXXXX XXXX XXXXXX
XXX  XXX XXXX XXXXXX
XXXp XXX   X  XXXXXX
XXX       pX  XXXXXX
XXX  XXX   X  XXXXXX
XXX  XXX X X  XXXXXX
XXX   XX X X  XXXXXX
XXX       XXXXXXXXXX
XXXX XXX XXXX    XXX
XX    XX XXXX    XXX
XX          D    XXX
XX      XXXXX    XXX
XX    XXXXXXX    XXX
XXXXXXXXXXXXXXXXXXXX
XXXXXXXXXXXXXXXXXXXX
XXXXXXXXXXXXXXXXXXXX