XXXXXXXXXXXXX
X   XXXXXXXXX
X    D  XXXXX
XX XXXXDX  XX
XX  D   D  XX
X  XXXX X  XX
X    XX XXXXX
X    X  XXXXX
X   XX  XXXXX
X  XXXXXXXXXX
XXXXXXXXXXXXX
XXXXXXXXXXXXX
XXXXXXXXXXXXX