XXXXXXXXXXXXXXX
XXXXXXXXXXXXXXX
XX  XXXXXXXXXXX
XX  X p  XXXXXX
XXX D    XXXXXX
XX   XX XXXXXXX
XX     XXXXXXXX
XX    XXXXXXXXX
XXX    XXXXXXXX
XXX       XXXXX
X         XXXXX
X         XXXXX
X    XXXXXXXXXX
XXXXXXXXXXXXXXX
XXXXXXXXXXXXXXX