XXXXXXXXXXXXXXXXXXXXXX
XXXXXXXXXXXXXXXXXXXXXX
XXXXXXXXXXXXXXXXXXXXXX
X     XXXXXXXXXXXXXXXX
X     XXXXXXXXXXXXXXXX
X    pXXXXXXXXXXXXXXXX
X   p XX  XXXXXXXXXXXX
X  pXXXX  XXXXXXXXXXXX
X            X   XXXXX
X  Dp XX  XX X   XXXXX
XX    XX         XXXXX
XX     X  XX X   XXXXX
XX        XX XX XXXXXX
XX      p XX XX XXXXXX
XX XX     XX XX XXXXXX
XX XX     XX XX XXXXXX
XX XX          XXXXXXX
XX             XXXXXXX
XXXXX  pp      XXXXXXX
XXXXXXXXXXXXXXXXXXXXXX
XXXXXXXXXXXXXXXXXXXXXX
XXXXXXXXXXXXXXXXXXXXXX