XXXXXXXXXXXX
XXXXXXXXXXXX
XXXXXX  XXXX
X  XXX  XXXX
X   XX  XXXX
Xp  XXX XXXX
X      XXXXX
X    XXXXXXX
X      XXXXX
X      XXXXX
XXXXXXXXXXXX
XXXXXXXXXXXX