XXXXXXXXXXXXXXXXXXXXXXX
XXXXXXXXXXXXXXXXXXXXXXX
XXXXXXXXXXXXXXXXXXXXXXX
X    XXXXXXXXXXXXXXXXXX
X    XXXXXXXXXXX  XXXXX
XXXX X D D        XXXXX
XXXX   XXXXXXXXX  XXXXX
XX     XXXXXXXXXX XXXXX
XX     XXXXXXXXXX XXXXX
XX            XXX XXXXX
XX     X X    XXX XXXXX
X      X X       XXXXXX
X    XXX X    XXXXXXXXX
X             XXXXXXXXX
Xp   XXX      XXXXXXXXX
XX      p     XXXXXXXXX
XX     p       XXXXXXXX
XX                XXXXX
XXX               XXXXX
XXX            XXXXXXXX
XXX          XXXXXXXXXX
XXXXXXXXXXXXXXXXXXXXXXX
XXXXXXXXXXXXXXXXXXXXXXX