XXXXXXXXXXXXX
XXXXXXXXXXXXX
X  XX  X   XX
X   D      XX
XX XX  X  pXX
XX XXD XX XXX
XX X   XX XXX
XX X   XX XXX
XX X   XX XXX
XX  p    XXXX
XXXXX  XXXXXX
XXXXXXXXXXXXX
XXXXXXXXXXXXX