XXXXXXXXXXXXXXXX
XXXXXXXXXXXXXXXX
XXXXXXXXXXXXXXXX
XXXXXXXXXXXXXXXX
X  XXXXXXXXXXXXX
X        XXXXXXX
X     p  XXXXXXX
X      XXXXXXXXX
XX  X  XXXXXXXXX
XX       XXXXXXX
Xp       XX  XXX
X            XXX
X            XXX
XXX  XXXXXXXXXXX
XXXXXXXXXXXXXXXX
XXXXXXXXXXXXXXXX