    XXXX
XXX XXXX
XXX XXXX
XX  XXXX
XX  XXXX
XXXXXXXX
XXXXXXXX
XXXXXXXX