XXXXX XXXXX XX
XXXXXXXXXXX XX
XXXXXXXX XX XX
XXXXXXX  XX XX
XXXXXXX  X   X
XXXXXXXX XDXXX
XXXXXXX  X XXX
XXXXXX      XX
XXX    X  X   
XXXXX      X X
XXXXXX   D X  
XXXXX  D  XXX 
XXXXX X XpXX  
XXXXX X X XX X