XXXXXXXXXXXXXXXXXXXXXXX
XXXXXXXXXXXXXXXXXXXXXXX
XXXXXXXXXXXXXXXXXXXXXXX
XXXXXXXX  XXXXXXXXXXXXX
XXXXXXXX  XXXXXXXXXXXXX
XXXXX     XXXXXXXXXXXXX
XXXX   X  XXXXXXXXXXXXX
XXXXp  X     XXXXXXXXXX
XXXX           XXXXXXXX
XXXX   XXD XXX XXX  XXX
XX     XX     D     XXX
XX     XXX       X  XXX
XXXX   X       p XX XXX
XXXX  p          XX XXX
XXXX                XXX
XXXX            XXX XXX
XXXX                 XX
XXXX                 XX
XXXX                 XX
XXXXX     p    XXX   XX
XXXXX      XXXXXXXXXXXX
XXXXXXXXXXXXXXXXXXXXXXX
XXXXXXXXXXXXXXXXXXXXXXX