XXXXXXXXXXXX
XXXXXXXXXXXX
XXXXXXXXXXXX
XXXXXXXXXXXX
XXXXXXX   XX
X    XX   XX
X    XXX XXX
X   XXXX XXX
X     XX XXX
X       XXXX
XXXXXXXXXXXX
XXXXXXXXXXXX