XXXXXXXXXX
XXXXXXXXXX
XXXXXXXXXX
X  XXXXXXX
X  XXXXXXX
XXD  XXXXX
X      XXX
X   X  XXX
XXXXXXXXXX
XXXXXXXXXX