XXXXXXXXXXXXXXXXXXXXXXXX
XXXXXXXXXXXXXXXXX    XXX
XXXXXXXXXXXXXXXXXp   XXX
XXXXXXXX             XXX
XX       XXXXXXXX    XXX
XX       XXXXXXXXXX XXXX
XX       XXXXp      XXXX
XXX X X   XXX       XXXX
XXX   X   XXX      pXXXX
XXX   X   XXX       XXXX
XXX                  XXX
XXX   X   XXX        XXX
X         XXX        XXX
X             D  XXX XXX
X      XXXXXXXX  XXX XXX
XXXXX XXXXXXXXX  XX  XXX
XXXXX            XX  XXX
XXXXXXXXXXXXXXX  XX  XXX
XXXXXXXXXXXXXXXX     XXX
XXXXXXXXXXXXXXXXXXX  XXX
XXXXXXXXXXXXXXXXXXX  XXX
XXXXXXXXXXXXXXXXXXXXXXXX
XXXXXXXXXXXXXXXXXXXXXXXX
XXXXXXXXXXXXXXXXXXXXXXXX