XXXXXXXXXXXXXXXXXXXXXX
XXXXXXXXXXXXXXXXXXXXXX
XXXXXXX   XXXXXXXXXXXX
XXXXXXX         XXXXXX
XX   p X XXXXXX XXXXXX
XX           p    XXXX
XX   p X XXX      XXXX
XXXX XXX XXX      XXXX
XXXX XXX XXX      XXXX
XXXX XXX XXX      XXXX
XXXX      XX      XXXX
XXXX      XX XXXXXXXXX
X         XX XXXXXXXXX
X                XXXXX
XX  p         X  XXXXX
XX               XXXXX
XX       X XX     XXXX
XXX      X XX     XXXX
XXX          X    XXXX
XXXXXXX           XXXX
XXXXXXXXXXXXXXXXXXXXXX
XXXXXXXXXXXXXXXXXXXXXX