XXXXXXXXXX
XXXX  XXXX
XXXX  XXXX
XXXXX XXXX
XX  XDXXXX
XX    XXXX
XXX  XXXXX
XXXXXXXXXX
XXXXXXXXXX
XXXXXXXXXX