XXXXXXXXXXXXXXXX X
XXXXXXXXXXXXXXXXXX
XXXXXXXXXXXXXXXXXX
XXXXXXXXXXXXXXX XX
XXXXXXXXXXXXXXX  X
XXXXXXXXXXXXXXX XX
XXXXXXXXXX  X    X
XXXXXXXXX    XX   
XXXXXXXXX    XXXX 
XXXXXXXXX  XX  XXX
XXXXXXXXX  XXX    
XXXXXXXXX    XXXXX
XXXXXXXXX  XXXXXXX
XXXXXXXX   XXXXXXX
XXXXXXXX X XXXXXXX
XXXXXX     XXXXXXX
X  XXXX    XXXXX  
XXXXXXXXX  X   XXX