XXXXXXXXXXXXXXX
XXXXXXXXXXXXXXX
XXXXXXXXXXXXXXX
XXXXXXXXXXXXXXX
XX   XXXXXXXXXX
XX   XXXXXXXXXX
XX   XXX   XXXX
XXp        XXXX
XX  p  X   XXXX
X      XX X pXX
X            XX
X           XXX
X         XXXXX
XXXXXXXXXXXXXXX
XXXXXXXXXXXXXXX