XXXXXXXXXXXXXXXXXXXXXX
XXXXXXXXXXXXX  XXXXXXX
XXXX           XXXXXXX
XXXX   XXXXXXX XXXXXXX
XXXX   XXXXXXX XXXXXXX
X  X   XXXXXXX XXXXXXX
X  XX  XXXXXXX XXXXXXX
X      XXXXXXX XXXXXXX
X   p  XXXX  X XXXXXXX
X            X XXXXXXX
XX      XXXX X XXXXXXX
XX   p  XXXX X XXXXXXX
XX       XXX X XXXXXXX
X        XXX X XXXXXXX
X        XXX X XXXXXXX
X          X X XXXXXXX
XXX        X   XXXXXXX
XXX            XXXXXXX
XXX           XXXXXXXX
XXX           XXXXXXXX
XXXXXXXXXXXXXXXXXXXXXX
XXXXXXXXXXXXXXXXXXXXXX