XXXXXXXXXXXXXXXXXXX
XXXXXXXXXXXXXXXXXXX
XXXXXXXXXXXXX  XXXX
XXX            XXXX
XXX XX    XXXX XXXX
XXX XX    XXXX XXXX
XX  XX    XXXX XXXX
XX  XX    XXXX XXXX
X    XXX XXX    XXX
X      X XXX    XXX
XX       D      XXX
XXX      XXX    XXX
XXX XX   XXX    XXX
XXX XX   XXXXXX  XX
XXX              XX
XXXXXXXXXXXXXXXXXXX
XXXXXXXXXXXXXXXXXXX
XXXXXXXXXXXXXXXXXXX
XXXXXXXXXXXXXXXXXXX