XXXXXX XXXXXXXX
XXXXXX XX XXXXX
XXXXXX XX XXXXX
X  XXX pX   XXX
XX         XXXX
XXXX XXXX  XXXX
XX X XXXX  XXXX
XX   XXXXX   XX
XXD  XXXXX X  X
XX  XXXXXX   XX
X    XXXXX   XX
XX   XXXXX    X
XX   XXXXXX X X
XX  XXXXXX  X  
X    XXXXXD X  