XXXXXXXXXXXXXXXXX
XXXXXXXXXXXXXXXXX
XXXXXXXXXXXXXXXXX
XXXXXXXXXXXXXXXXX
XXXXXXXXXXXXXXXXX
XX  XXXXXXX  XXXX
XX  D        XXXX
X   XXXXXXXX XXXX
X   X   XXXX XXXX
X  D         XXXX
X   X p  XXX XXXX
XXX XXDX X    XXX
XX  XX X X    XXX
XX  XX    XXXXXXX
XX  XX    XXXXXXX
XXXXXXXXXXXXXXXXX
XXXXXXXXXXXXXXXXX