XXXXXXXXXXXXX
XXXXXXXXXXXXX
XXX   X  XXXX
XXX       XXX
XXX   X   XXX
XXX XXXX  XXX
XXX XXXX  XXX
XX  XXXX  XXX
XX  XXXX  XXX
XX  XXXXXXXXX
XXXXXXXXXXXXX
XXXXXXXXXXXXX
XXXXXXXXXXXXX