XXXXXXXXXXXXXXXXXXXXXXXX
XXXXXXXXXXXXXXXXXXXXXXXX
XXX   pXXXXXXXXXXXXXXXXX
XXX    XXXX       XXXXXX
XXX X XXXXXp      XXXXXX
XXX XDXXXXX       XXXXXX
XXX     p         XXXXXX
XXX       X       XXXXXX
XXX   p p X       XXXXXX
XXX       XXXX XXXXXXXXX
XXX       XXXX     XXXXX
XXX       XXXX     XXXXX
XXX        XXXX    XXXXX
X          XXXXXX XXXXXX
X          D     DXXXXXX
X          XXX    XXXXXX
XX          XX p  XXXXXX
XX          XX   XXXXXXX
XX          XX   XXXXXXX
XX        p XX   XXXXXXX
XX    p XXXXXX   XXXXXXX
XXXX    XXXXXXXXXXXXXXXX
XXXXXXXXXXXXXXXXXXXXXXXX
XXXXXXXXXXXXXXXXXXXXXXXX