XXXXXXXXXXXX
XXX XXXXXXXX
XX  XXXXXXXX
XX XX XXXXXX
X DX  XXXXXX
XXXXD XXXXXX
XXXX XXXXXXX
XXXXDXXXXXXX
XXXX XXX XXX
X X DXX  XXX
X X   XDXXXX
X X      XXX