XXXXXXXXXXXXXXXXX
XXXXXXXXXXXXXXXXX
XXXXXXXXXXXXXXXXX
XXXXXXXXXXXXXXXXX
XXXXXXXXXXXXXXXXX
XXXX   XX  XXXXXX
XXXX        D XXX
XXX        XX XXX
XXX X XXX  XX XXX
XXX X XXXX XXDXXX
X     XXXX XX XXX
X    XXXXX XX XXX
X    XXXXX XX XXX
XX        XX   XX
XXXXXXXXXXXX   XX
XXXXXXXXXXXXXXXXX
XXXXXXXXXXXXXXXXX