XXXXXXXXXXXXXXXXXXXX
XXXXX XX  XXXXXXXXXX
XXXX pXX XXXXXXXXXX 
XXXXX    XXXXXXXXX  
XXXXXXXXXXXXXXXXX  D
XXXXXXXXXXXXXXXXX D 
XXXXXXXXXXXXXXX   X 
XXXXXXXXXXXXXX  p   
XX XXXXXX XX    XXXX
XX        XXp pXXXD 
X  X XXX  XX   XX XX
XXXXXXXX DX         
XXXXXXXX      XX    
XXXXXXXXXXXX XXXX   
XXXXXXXXXXX  XXXXXXX
XXXXXXXX    XXXXXXXX
XXXXXXXXXXXXXXXXXXXX
XXXXXXXXXXXX  XXXXXD
XXXXXXXXXXXXX  p    
XXXXXXXXXXXXXXXXXXX 