XXXXXXXXXXXXXXXXXXXXXXXX
XXX X X X D    X XXXX   
XXX   X X X      XXXX  X
X                       
X XXX   XXX X   XXXXX XX
X  XX    XX   X XXXX  XX
XX      pXX  XX XXXX XXX
XXXX   XXXX  XX XXD  XXX
XXXXXX XXXX  XX    XXXXX
XXXXXX XXXXXDXXX X XXX  
XXXXXX   XXX XXX X XXX  
XXXXXX  XXX  XXX X XXX X
XXXXXXX  XXX     X XXX X
XXXXXXXX                
XXXXXXX    XXXXXXX  XX X
XXXXXXX     XXXXXX XXX  
XXXXXXX   X XXXD   XXXX 
XXXXXXXX    XX    XXXXX 
XXXXXXX    XXX XXXXXXXX 
XXXXXXX X  XXXXXXXXXXXXX
XXXXXX    XXXXXXXXXXXXXX
XXXXXX  XXXXXXXXXXXXXXXX
XXXXXX XXXXXXXXXXXXXXXXX
XXXXXX XXXXXXXXXXXXXXXXX