XXXXXXXXXXXXXXXX
XXXXXXXXXXXXXXXX
XXXXXXXXXXXXXXXX
XXXXXXXXXXXXXXXX
XXXX    XX    XX
XXXX    XX    XX
XXXXXX  XXXX XXX
X   XX  XXXX  XX
X             XX
X             XX
X             XX
XX     XX XX  XX
XX   XXX  XX  XX
XXXX      XXXXXX
XXXXXXXXXXXXXXXX
XXXXXXXXXXXXXXXX