XXXXXXXXXXXXXXXX
XXX  XXXXXXXXXXX
XXX p      XXXXX
XXXX XXXXX XXXXX
XXXX XXXXX XXXXX
X p  XXXXX XXXXX
X    XXXXX XXXXX
X    XXXXX XXXXX
XXXDXXXXXX XXXXX
XXX XXXXX   XXXX
XXX X       XXXX
XXX         XXXX
XXXXX       XXXX
XXXXXXXXXXXXXXXX
XXXXXXXXXXXXXXXX
XXXXXXXXXXXXXXXX