XXXXXXXXXXXXXXXXXXXXXXX
XXXXXXXXXXXXXXXXXXXXXXX
XXXXXXXXXXXXXXXXXXXXXXX
XX   XXXXXXXXXXXXXXXXXX
XX    XXXXXXXXXXXXX  XX
XX    XXXXXXXXXXXXX  XX
XXX X            D   XX
XXX X  XXXX   p  XX  XX
XXX XD XXXXX X XXXXp XX
XXX X  XXX   X XXXXXXXX
XXX    X     X XXXXXXXX
XXX p  X X   X XXXXXXXX
XXXD   X XX  X XXXXXXXX
XXX           XXXXXXXXX
XXX    X XX  XXXXXXXXXX
XXX p  X       XXXXXXXX
XXX            XXXXXXXX
XXX      p     XXXXXXXX
XXX            XXXXXXXX
XXX            XXXXXXXX
XXX   pp    XXXXXXXXXXX
XXXXXXXXXXXXXXXXXXXXXXX
XXXXXXXXXXXXXXXXXXXXXXX