XXXXXXXXXXXXXX
XXXXX X X X  X
XXXXX  pX XX X
XXXXX     XX X
XXXXX   pD   X
X XXX      XXX
XXXXXX  X   XX
XXXXXXX  X  XX
XXXXXXp XX D X
XXXXXX XXX   X
XXXXXXXXXXX XX
XXXXXXXXXXX XX
X XXXXXXXXXDXX
X XXXXXXXX  XX