XXXXXXXXXXXX
XXXXXXXXXXXX
XXXXXXXXXXXX
XXXXXXXXXXXX
XXX  XXXXXXX
XXX      XXX
XXXX XXX XXX
XX   XX  XXX
X    XX  XXX
X   XXX  XXX
XXXXXXXXXXXX
XXXXXXXXXXXX