XXXXXXXXX
XXXXXXXXX
XXXX  XXX
X  D  XXX
X  XX XXX
XXXX  XXX
XXXX  XXX
XXXXXXXXX
XXXXXXXXX