XXXXXXXXXXXXXXXXXXXXX
XXXXXXXXXXXXXXXXXXXXX
XXXXXXXXXXXXXXXXXXXXX
XXXXXXXXXXXXXXXXXXXXX
XXXXXXXXXXXXXXXXXXXXX
XXXXXXXXXXXXXXXXXXXXX
XXXXX     XXXXXXXXXXX
XXXXX     XXXXXXXXXXX
XX  Xp   p D    XXXXX
XX  X     XXXXX XXXXX
X         XXXXX XXXXX
Xp           XX XXXXX
X          p      XXX
X      p          XXX
X                 XXX
X       p  X      XXX
XXD       XXXX     XX
XX       p         XX
XXXX      XXXXXXXXXXX
XXXXXXXXXXXXXXXXXXXXX
XXXXXXXXXXXXXXXXXXXXX