XXXXXXXXXXXXXXXXXX
XXX     XXXXXXXXXX
XXX     XXXXXXXXXX
XXX     XXXXXXXXXX
XXX     XXXXXXXXXX
XXX     XXXXXXXXXX
XXXXX  XXXXXXXXXXX
X      XXXXXXXXXXX
X      XXXXXXXXXXX
X      XXXX    XXX
X      XXXX    XXX
X              XXX
X   p     X    XXX
X      X  X    XXX
X     pXXXXXXXXXXX
XXXX   XXXXXXXXXXX
XXXXXXXXXXXXXXXXXX
XXXXXXXXXXXXXXXXXX