XXX XXXX
XX  XXXX
XX XX   
XXpXXXXX
XX XXXXX
X  XXXXX
X XXXXXX
X XXX XX