XXXXXXXXXXXXX
XXXXXXXXXXXXX
XXXXXXXXXXXXX
XXXX  XXXXXXX
XXXX  XXXXXXX
XXXX  XXXXXXX
XX    XXXXXXX
X    DXXX  XX
X          XX
X       X  XX
X       XXXXX
XXXXXXXXXXXXX
XXXXXXXXXXXXX