XXXXXXXXXXXXXXXX
XXXXXXXX   XXXXX
XXXXXD     XXXXX
XXXXX XXX XXXXXX
XXX    XX XXXXXX
XX     XX XXXXXX
XX X  XXX XXXXXX
X  X  XXX XXXXXX
X          XXXXX
X  X pXXX   XXXX
XXXX   XX   XXXX
XXXX   XX   XXXX
XXXX   XX   XXXX
XXXXXXXXXXXXXXXX
XXXXXXXXXXXXXXXX
XXXXXXXXXXXXXXXX