XXXXXXXXXXXX
XXXXXXXXXXXX
X  X  XXXXXX
X      D  XX
XX X  XXD XX
XX    X   XX
X     X   XX
X      X  XX
X        pXX
X    XXX pXX
XXXXXXXXXXXX
XXXXXXXXXXXX