XXXXXXXXX
Xp XXXXXX
X  X  XXX
XX  p XXX
XX XX XXX
X pX  XXX
Xp    XXX
XXXXXXXXX
XXXXXXXXX