XXXXXXXXXXXXXXXXXXX
XXXXXXXXXXXXXXXXXXX
XXXXXXXXX     XXXXX
XXX     X     XXXXX
XXX           XXXXX
XXX     X     XXXXX
XXX     XXX XXXXXXX
XXX     XXX XXXXXXX
XX     XXXX XXXXXXX
X        XX XXXXXXX
X               XXX
X         XXXXX XXX
XXX XX XX XXXXX XXX
XXX XX X  XXXXX XXX
XXX XX X  XXX    XX
XXX      p       XX
XXXXXXXX  XXXXXXXXX
XXXXXXXXXXXXXXXXXXX
XXXXXXXXXXXXXXXXXXX