XXXXXXXXXXXXXXXXXXXXXXX
XXXXXXXXXXXXXXXXXXXXXXX
XX   XXXXXXXXXXXXXXXXXX
XX   XXXXXXXXXXXXXXXXXX
XX   XXXXXXXXXXXXXXXXXX
XX   XXXXXXXXXXXXXXXXXX
XX   XXXXXXXXXXXXXXXXXX
XX   XXXXXXXXXXXXXXXXXX
XXX XXXXXXXXXXXXXXXXXXX
XXX XXXXXXXXXXXXXXXXXXX
X         XXXXXXXXXXXXX
X      p  XXXXXXXXXXXXX
X   p     XX      XXXXX
XX      p XX      XXXXX
XX                XXXXX
XX                XXXXX
XX            p   XXXXX
XX          XXX XXXXXXX
XX             XXXXXXXX
XX     XXXXXXXXXXXXXXXX
XXXXXXXXXXXXXXXXXXXXXXX
XXXXXXXXXXXXXXXXXXXXXXX
XXXXXXXXXXXXXXXXXXXXXXX