XXXXXXXXXXXXXXXXXXXXX
XXXXXX  XXXXXXXXXXXXX
XXXXXX  XXXXXXXXXXXXX
XXXXX   XXXXXXXXXXXXX
X       XXXXXXXXXXXXX
X       XXXXXXXXXXXXX
X       XXXXXXXXXXXXX
XXXX DX XXXXXXXXXXXXX
XX    X XXXX     XXXX
XX     XXXXX     XXXX
X        XXX     XXXX
X            X XXXXXX
XX        X  X XX  XX
XX    p            XX
XX           XXXXX XX
XX                XXX
XXXX         XXXXXXXX
XXXX         XXXXXXXX
XXXXX   XXXXXXXXXXXXX
XXXXXXXXXXXXXXXXXXXXX
XXXXXXXXXXXXXXXXXXXXX