XXXXXXXXXXXXXXXXXXXXX
XX     XXXXXXXXXXXXXX
XX     XXXXXXXXXXXXXX
XX     XXXXXXXXXXXXXX
XXX  XXXXXXXXXXXXXXXX
XXXD XXXXXXXXXXXXXXXX
XX     XXXXXXXXXXXXXX
XX   p             XX
XX     XXXXX XXX   XX
XXXX               XX
XXXX X       XXX   XX
XXXX X           XXXX
XXXX      XX XXX XXXX
XXXX         XXX XXXX
XX          pXX  XXXX
XX           XX  XXXX
XX               XXXX
XX    XX     XX  XXXX
XXXXXXXX     XXXXXXXX
XXXXXXXXXXXXXXXXXXXXX
XXXXXXXXXXXXXXXXXXXXX