 XXXXXXXXXXXX
XXXXXXX   XXX
X  XX    XX  
      XXXXX X
XXXX  XX DX  
XXXX        D
XXXXXXXX   X 
XXXXXXXXXXXXX
XXXXXXXXXXXXX
XXXXXXXXXXXXX
XXXXXXXXXXXX 
XXXXXXXXXXXXX
XXXXXXXXXXXXX