XXXXXXXXXXXXXXXXXXXXXXXX
XXXXXXXXXXXXXXXXXXXXXXXX
X pXXXXXXXXXXXXXXXXXXXXX
X  XXXXXXXXXXXXXXXXXXXXX
X      XXXXXXXXXXXXXXXXX
X  XXX XXXXXXXXXXXXXXXXX
X  XXX XXXXXXXXXXXXXXXXX
XXXXXX X    XXXXXXXXXXXX
X      X    XX  XXXXXXXX
X      X    XX  XXXXXXXX
X           XX  XXXXXXXX
X      X    XX  XXXXXXXX
X      X    XX  X    XXX
X      XXX XXX       XXX
X         XXXX  X    XXX
X            XXXXXX XXXX
X          X XXXXXX XXXX
XX           XXXXXXDXXXX
XXX          XXXXXX XXXX
XXX           XXXXX XXXX
XXX       X        XXXXX
XXX    XXXX   XXXXXXXXXX
XXXXXXXXXXXXXXXXXXXXXXXX
XXXXXXXXXXXXXXXXXXXXXXXX