XXXXXXXXXXXXXXXXXXXXXXX
XXXXXXXXXXXXX     XXXXX
XXXXXXXXXXXXX     XXXXX
XXXXXXXXXXXXX     XXXXX
XXX   XXXXXXX     XXXXX
XXX   XXXXXXX     XXXXX
XXXp  XXXXXXX     XXXXX
XXX   X  XXXXXX    XXXX
XXX   X            XXXX
XXX   X  XXXXXX    XXXX
XXXX     XXXXXXX    XXX
X      p            XXX
X        X  XXXX    XXX
X           XXXXX   XXX
X  p               pXXX
X             XX     XX
X               p    XX
XXX           XX     XX
XXX           XXXXXXXXX
XXXXX   XXXXXXXXXXXXXXX
XXXXXXXXXXXXXXXXXXXXXXX
XXXXXXXXXXXXXXXXXXXXXXX
XXXXXXXXXXXXXXXXXXXXXXX