XXXX XXXXXXXXXXXXXXXX
XXX  XXX p XXX   XXXX
XXXX XX    XXX X XXXX
XXX  XX    XXX X  XXX
XX  XXXX X XXX   XXXX
XX   XX        XDXXXX
XXXX X    XX      XXX
XXXX X            XXX
XXXX X  XX X   XX  XX
XXXX     X  Dp XXX XX
XXXX X   X XXX   X XX
X  X   p D         D 
XX  X   XX XXXXX X XX
XXX X X    XXXXX X XX
XXX XX   X  XXXX X  X
XXX       XXXXXX  XXX
XXXX X XX   XXXXX XXX
XXXX    XX  XXXXXXXXX
XXXXX  XXXXXXXXXXXXXX
XXXXXXXXXXXXXXXXXXXXX
XXXXXXXXXXXXXXXXXXXXX