XXXXXXXXXXXXX
XX   XXXXXXXX
XX   XXXXXXXX
XX   XXXXXXXX
XXX XXXXXXXXX
X p XXXXXXXXX
X     XXX  XX
X          XX
X       X  XX
X      XXXXXX
XX     XXXXXX
XXXXXXXXXXXXX
XXXXXXXXXXXXX