      XX
XXXXX XX
XXXXX XX
X  XX XX
Xp X  XX
XX    XX
XXXXXXXX
XXXXXXXX