XXXXXXXXXXXXXXXXXXXXXX
XXXXXXXXXXXXXXXXX   XX
XXXXXXXXXXXXXXXXX   XX
XXXXXXXXXXXXXXXXX   XX
XXXXX               XX
XXX   XXXXXXXXXXX   XX
XXX   XXXXXXXXXXX   XX
XXX   XXXXXXXXXXXX XXX
XXXX  XXXXXXXXXXXX XXX
XXXX           XXX XXX
XXXX  XXXXXXXX XXX XXX
XXX       XXXX XXX XXX
X        pXXXX XXX XXX
X            X XXX XXX
X            p    XXXX
X         XXX   XXXXXX
X               XXXXXX
X      XXXXXX   XXXXXX
XXXXXXXXXXXXXXXXXXXXXX
XXXXXXXXXXXXXXXXXXXXXX
XXXXXXXXXXXXXXXXXXXXXX
XXXXXXXXXXXXXXXXXXXXXX