XXXXXXXXXXXXXXXXXXX
XXXXXXXXXXXXXXXXXXX
XXX  XXXXXXXXXXXXXX
XXX           XXXXX
XXXX XXXXXXX  XXXXX
XXXX XXXXXXX  XXXXX
XX   XXXXXXX  XXXXX
X    XXXXXXXXXX  XX
X            XX  XX
X        D       XX
X  p XX   XX XX  XX
X                XX
XX   XX   XXDXXXXXX
XX   XXXXX     XXXX
XX             XXXX
XXXXXXXXXX     XXXX
XXXXXXXXXXXXXXXXXXX
XXXXXXXXXXXXXXXXXXX
XXXXXXXXXXXXXXXXXXX