XXXXXXXXXXXXXXXXXXXXXXX
XXXXXXXXXXXXX  XXXXXXXX
X      XX      XXXXXXXX
X      XX XXX  XXXXXXXX
X   p  XX XXXX   XXXXXX
X                XXXXXX
X       X XXXX   XXXXXX
XXXX XX X XXXX X XXXXXX
XXXX XX X XXXX X XXXXXX
XXXX XX X XXXX X XXXXXX
XXXX     DXXXX X XXXXXX
XXXX      p   XX XXXXXX
XXXX X      XXXX XXXXXX
XXXX        XXXX XXXXXX
XXXXXX      XXXX XXXXXX
XX    XXXX    XX XXXXXX
XX    XXXX    XX XXXXXX
XX              XXXXXXX
XX    XXXX    XXX   XXX
XXXXXXXXXXXX        XXX
XXXXXXXXXXXXXXXXX   XXX
XXXXXXXXXXXXXXXXXXXXXXX
XXXXXXXXXXXXXXXXXXXXXXX