XXXXXXXXXXXXXX
XXXXXXXXXXXXXX
XXXXXXXXXXXXXX
XXXX  XXXXXXXX
XXXX      XXXX
XXXX  XXX XXXX
XXXXX XXX XXXX
XXX     X XXXX
XXX     X XXXX
XXX        XXX
XXXXXX     XXX
XXXXXX  p  XXX
XXXXXXXXXXXXXX
XXXXXXXXXXXXXX