XXXXXXXXXX
X  XX  XXX
X     pXXX
XXX  X XXX
X    X XXX
X      XXX
X      XXX
X      XXX
XXXXXXXXXX
XXXXXXXXXX