XXXXXXXXXXXXXXXX
XXXXXXXXXXXXXXXX
XXXXXXXXXXXXXXXX
XXXXXXXXXXXXXXXX
XXXXXXXXXXXXXXXX
X   XXXXXXXXXXXX
X   XXXXXXXXXXXX
XX    XXX  pXXXX
X     XXX   XXXX
X         XXXXXX
XX    XXXXXXXXXX
XX        XXXXXX
X       p XXXXXX
X    XXp  XXXXXX
XXXXXXXXXXXXXXXX
XXXXXXXXXXXXXXXX