XXXXXXXXXXXX
XXX XXXXXXXX
 XX XXXXXXXX
X D XXXXXXXX
X  XXXXXXXXX
X  XXXXXXXXX
XX  XXXXXXXX
XX XXXXXXXXX
XX XXXXXXXXX
XX  XXXXXXXX
XX  XXXXXX X
X  XXXDX  D 