XXXXXXXXXXXXXXXXXXXXXXXX
XXXXXXXXXXXXXXXXXXXXXXXX
X      XXXXXXXXXXXXXXXXX
X      XXXXXXXXXXXXXXXXX
X      XXXXXXXXXXXXXXXXX
XXX DXXXXXXXXXXXXXXXXXXX
XXX      XXXXXXXXXXXXXXX
XXX      XXXXXXXXXXXXXXX
XXp     XXXXXXXXXXXXXXXX
XX       XXXX    XXXXXXX
XX       XXXX    XXXXXXX
XXX       XXXXX XXXXXXXX
X               XXXXXXXX
X              XXXXXXXXX
X             XXXXXXXXXX
X    p   X  XXXXX   XXXX
X              D    XXXX
X            XXXX   XXXX
X              D    XXXX
X            XXXX   XXXX
X            XXXX   XXXX
X  p         XXXXXXXXXXX
XXXXXXXXXXXXXXXXXXXXXXXX
XXXXXXXXXXXXXXXXXXXXXXXX