XXXXXXXXXXXX
XXXXXXXX   X
XXXXXXXXp   
XXXXXXX     
XXXXXXXX    
XXXXXXXX    
XXXXXXXXX  X
XXXXXXXXX XX
XXXXXXXXXXXX
XXXXXXXXXXXX
XXXXXXXXXXXX
XXXXXXXX  XX