XXXXXXXXXXXXXXXXXXXXXX
XXXX  X X XXXXX   X  D
XXXX         XXX  XX X
XXXXX  X   X XX   XX  
XXXXXXXXX  X  X XXX  X
XXXXXXXX   XX    XX   
XXXXXXXXXXXXXXXXD    X
XXXXXXXXXXXXXXXX    XX
XXXXXXXXXXXXXXX   D XX
XXXXXXXXXXXXXXXXX  XXX
XXXXXXXXXXXXXXXXXX XXX
XXXXXXXXXXXXXXXXX  XXX
XXXXXXXXXXXXXXXX   XXX
XXXXXXXXXXXXXXXXX  XXX
XXXXXXXXXXXXXXXX   XX 
XXXXXXXXXXXXXXX  XXXXX
XXXXXXXXXXXXXXXXXXXXXX
XXXXXXXXXXXXXXXXXXXXXX
XXXXXXXXXXXXXXXXXXXXXX
XXXXXXXXXXXXXXXXXXXXXX
XXXXXXXXXXXXXXXXXXXXXX
XXXXXXXXXXXXXXXXXXXXXX