XXXXXXXXXXX
X  XXXXXXXX
X   XXXXXXX
X   XXXXXXX
X    XXXXXX
XX   XXXXXX
XX   XX  XX
X    XX  XX
X     D XXX
XXXXXXXXXXX
XXXXXXXXXXX