XXXXXXXXXX
XXXXXXXXXX
XXXX  XXXX
XXXX  XXXX
XXXXX XXXX
XXXXX XXXX
XXX   XXXX
XXX   XXXX
XXXXXXXXXX
XXXXXXXXXX