XXXXXXXXXXXXXXXXXXX
XXXXXXXXXXXXXXXXXX 
XXXXXXXXXXXXXXX  XX
XXXXXXXXXXXXXXXX XX
XXXXXXXXXXX XX    X
XXXXXXXXXXX XXD X X
XXXXXXXX  D        
XXXXXXXX  XXXXX   X
XXX XX   XD    X   
XXX       DXXX   X 
 X  XXXXXX     X   
   XXXXXXXXX  pX   
XXXXXXXXXXX  X     
XXXXXXXXXXX  XXXX  
XXXXXXXXXXXXXXXXXXX
XXXXXXXXXXXXXX  X D
XXXXXXXXXXXXXX    X
XXXXXXXXXXXXXXXXXXX
XXXXXXXXXXXXXXXXXXX