XXXXXXXXX
XXXXX  XX
XX     XX
XX  X  XX
X pXX  XX
Xp   X XX
X     XXX
XXXXXXXXX
XXXXXXXXX