XXXXXXXXXXXXXXXXXXXXXXX
XXXXXXXXXXXXXXX X     X
XXXXXXXXXXXXXXX   X  XX
XXXXXXXXXXXXXXXX  XX   
XXXXXXXXXXXXXXXXXXXX   
XXXXXXXXXXXXXXXXXX   X 
XXXXXXXXXXXXXXXXXX  D  
XXXXXXXXXXXXXXXX   XXXX
XXXXXX      XX X XXXXXX
XXXXXXXX XX      XXXXXX
XXXXXX   X   XX   X  XX
XXXX       X XXX  X   X
XXXXXXXXXXX            
XXXXXXXXXXX   X XXXXXX 
XXXXXXXXX              
XXXXXXXXXXXX           
XXXXXXXXXXXXXXXXX      
XXXXXXXXXXXXXXXXXXXX X 
XXXXXXXXXXXXXXXXXXXXXXX
XXXXXXX   XXXXXXXXXXXXX
XXXXXXXXX  XXXXXXXXXXXX
XXXXXXXXXX   XXXXXXXXXX
XXXXXXXXXXXX  XXXXXXXXX