XXXXXXXXXXXXXXXXXXXX
XXXXXXXXXXXXXXXXXXXX
XXXXXXXXXXXXXXXXXXXX
XXXXXXXXXXXXXXXXXXXX
XXXXXXXXXXXXXXXXXXXX
XXXX   XXXXXXXXXXXXX
XXXX             XXX
XXXX   XXXXXXXXX XXX
XXXXX XXXXXXXXX  XXX
XXXX       p     XXX
XXX      p    XX XXX
XXX           XX XXX
XXXp          XX XXX
XXX    X      XX XXX
XXXX     XX       XX
XX     p          XX
XX           XXXXXXX
XXXXXXX      XXXXXXX
XXXXXXXXXXXXXXXXXXXX
XXXXXXXXXXXXXXXXXXXX