XXXXXXXXXXXXXXXXXXXX
XXXXXXXXXXXXXXXXXXXX
XXXXXXXXXXXXXXXXXXXX
XX   XXXXXXXXXXXXXXX
XX   XXXXXXXXXXXXXXX
XX   XXXXXXXXXXXXXXX
XX   XXXXXXXXXXXXXXX
XX   XXXXXXXXXXXXXXX
XXX X   XXX     XXXX
XXX X   XXX     XXXX
XXX     XXXX  XXXXXX
XX      XXXX  XXXXXX
XX  p             XX
X            XXXX XX
X             XXX XX
XX            XXX XX
XX            XX  XX
XX                XX
XXXXXXXXXXXXXXXXXXXX
XXXXXXXXXXXXXXXXXXXX