XXXXXXXXXXXXXXXXX
XX   pXXXXXXXXXXX
XX          XXXXX
XXXX XXXXXX XXXXX
XXXX XXXXXX XXXXX
XXXXDp XXXX XXXXX
XXXX   XXXX XXXXX
XX     XXXX XXXXX
XX     XXXX XXXXX
XX      XXX XXXXX
XX      X    XXXX
XXXX    X    DXXX
XXX     XXXXX XXX
XXX     XXXX  XXX
XXXX    XXXX  XXX
XXXXXXXXXXXXXXXXX
XXXXXXXXXXXXXXXXX