XXXXXXXXXXXX
XXXXXXXXXXXX
XXXXXXXXXXXX
XX  XXXXXXXX
XX  XXXXXXXX
X    X  XXXX
X       XXXX
X p      XXX
X    XX  XXX
X   XXX  XXX
XXXXXXXXXXXX
XXXXXXXXXXXX