XXXXXXXXXXXXXXXXXXXX
XXXXXXXXXXXXXXXXXXXX
XXXXXXXXXXXXXXXXXXXX
X  XXXXXXXXXXXXXXXXX
Xp XXXXXXXXXXX  XXXX
X  XXXXXXXXXXX  XXXX
X               XXXX
X  XXXXXXXXXXX  XXXX
X     D  XXXXX  XXXX
X   XXX  XXXX   p XX
X   XXX       p   XX
X   p X  XXXX     XX
X     X   XXXXX XXXX
X         XXXXX XXXX
X               XXXX
X              XXXXX
X         XXXXXXXXXX
X      XXXXXXXXXXXXX
XXXXXXXXXXXXXXXXXXXX
XXXXXXXXXXXXXXXXXXXX