XXXXXXXXXXX
XXXXXXXXXXX
XXXXXXXXXXX
X  XXXXXXXX
X    D  XXX
XX  XXX XXX
XX  XX  XXX
XXX     XXX
XXXXXXXXXXX
XXXXXXXXXXX
XXXXXXXXXXX