XXXXXXXXXXXX
X   XXXXXXXX
X     XXXXXX
X  XX XXXXXX
X     XXXXXX
XX    XXXXXX
X     XX  XX
X         XX
Xp        XX
X      XXXXX
XXXXXXXXXXXX
XXXXXXXXXXXX