XXXXXXXXXXXXXXXX
XXXXXXXXXXXXXXXX
X    XXXXXXXXXXX
X   p      DXXXX
X    D p XX XXXX
XXX  XX  XX XXXX
X      pDXX XXXX
X   D   XXX XXXX
X p  X XXXX XXXX
X    X   X   XXX
X        X   XXX
X            XXX
X        X   XXX
XX     p XXXXXXX
XXXXXXXXXXXXXXXX
XXXXXXXXXXXXXXXX