XXXXXXXXXXXXXXXXXXXXX
XXp     XXXXXXXXXXXXX
XX   p  XXXXXXXXXXXXX
XX  p   XXXXXXXXXXXXX
XX      XXXXXXXXXXXXX
XXXX DXXXXXXXXXXXXXXX
XXXX  XXXXXXXXXXX  XX
XXXX      D        XX
Xp     XXXXXXXXXXXXXX
X               XXXXX
X          XXXX XXXXX
X     DX   XXX  XXXXX
X          XXX  XXXXX
X           p   XXXXX
X            X  XXXXX
X        p   X  XXXXX
X            XXXXXXXX
XXXX         XXXXXXXX
XXXXXXXXXXX  XXXXXXXX
XXXXXXXXXXXXXXXXXXXXX
XXXXXXXXXXXXXXXXXXXXX