XX XXXX XXXXXXXXXX XXXp
XXXXX  XXXXXXXXXXXXXXXX
XXXXDpXXXXXXXXXXXXXXXXX
XXXXX XXXXXXXXXXXXXXXXX
XXXXXXXXXXXXXXXXXXXXXXX
XXXXXXXX XXXXXXXXXXXXXX
XXXXXXXX XXXXXXXXXXXXXX
XXXXXXXX XXXXXXXXXXXXXX
XXXXXXXX  XXXXXXXXXXXXX
XXXXXXXXX XXXXXXXXXXXXX
XXXXXXXXX XXXXXXXX     
XXXXXXXXX XXXXXXXX  X  
XXXXXXXXX    XXXXX     
XXXXXXXXXXXX  X X    pX
XXXXXXXXXXXXX      XX  
XXXXX  XX              
XXXX            XXXXXX 
XX   X XX   XXXXXXXXXXX
   XXX    XXXXXXXXXXXXX
X XXXXXXXXXXXXXXXXXXXXX
XXXXXXXXXXXXXXXXXXXXXXX
XXXXXXXXXXXXXXXXXXXXXXX
XXXXXXXXXXXXXXXXXXXXXXX