XXXXXXXXXXXXXXXXXXXXXXX
XXXXXXXXXXXXXXXXXXXXXXX
 pXXXXXXXXXXXXXXXX XXXX
X   XXXXXXXXXXXX   XXXX
X  XXXXXXXXXXXXX XXXXXX
XX   XXXXXXXXXX   XXXXX
XXXX  XXXXXXXX   XXXXXX
XXX    XXXXXXX X  XXXXX
X p X   XX     XX XXXXX
X XXX   X  XXXXXX XXXXX
X XX      X XXXXD XXXXX
X X pX       XXX XXXXXX
X   XX      XXXX XXXXXX
XX  XXX X   XXXX XXXXXX
X   XXX XX   XXX XXXXXX
X    XX  XX  XXX  XXXXX
X            XXXX XXXXX
X    X XXXX  XXX   XXXX
X   D  XXX p XXXX  XXXX
XD  X    X  XXXXX XXXXX
XX  XXX X     XXX XXXXX
XX   X      XXXXX XXXXX
XX X  XX   XXXXX  XXXXX