XXXXXXXXXXXXXXXXXXXXXXX
XXXXXXXXXXXXXXXXXXXXXXX
XXXXXXXXXXXXXXXXXXXXXXX
XXXXXXXXXXXXXXXXXXXXXXX
XXXXXXXXXXXXXXXXXXXXXXX
XXXX  XXXXXXXXXXXXXXXXX
XXXX  XXXXX      XXXXXX
XXXX  XXXXX      XXXXXX
XXXX             XXXXXX
XXXX      X      XXXXXX
XXXX      XXXX XXXXXXXX
XXXX      XXX   pXXXXXX
XXXX             XXXXXX
XXXX      XXXX  XXXXXXX
XXXX      D    XXXXXXXX
XX        XXXXDXXX   XX
XX                   XX
XXXXX      XXX   X   XX
XXXXX      XXX       XX
XXXXX      XXXX  X   XX
XXXXXXXXXXXXXXX  X   XX
XXXXXXXXXXXXXXXXXXXXXXX
XXXXXXXXXXXXXXXXXXXXXXX