XXXXXXXXX  X
X   XXXXXXXX
XXXXXXXXXXXX
XXXX XXXXXXX
X       X   
XXXXXXp    X
XXXXXXX   D 
XXXXX       
XXXXXXX XXXX
XXXXXXXXXXXX
XXXXXXXXXXXX
XXXXXXXXXXXX