XXXXXXXXXXX
XXXXXXXXXXX
XXXXXX  XXX
Xp  D   XXX
X       XXX
XX  XX  XXX
XXD XX  XXX
X   X   XXX
X  XX  XXXX
XXXXXXXXXXX
XXXXXXXXXXX