XXXXXXXXXXXXXXXXXXXXXXX
     XX  XXX XXXXX  DXX
X    DX  XXXXXXXXXXXp X
XX XX   XXXXXXXXXXXXX X
XX  XX  XXXXXXXXXXXXX  
XX DXX XXXXXXXXXXXXX   
XX XXX XXXXXXXXXXXXXX  
XX XXX XXXXXXXXXXXXXX  
XXXXXX XXXXXXXXXXXXX  X
X      XXXXXXXXXXXX   X
XXXX X  XXXXXXXXXXX XXX
X  X    DXXXXXXXXX  XXX
XX XXXX  XXXXXXXXX  XXX
X  XXX    XXXXXXXX     
X XXXX  XXXXXXXXXXX X  
XXXXXXX XXXXXXXXXXX   X
XXXXXXX XXXXXXXXXXXX  X
X XXXXX XXXXXXXXXXXXX X
  XXXXX XXXXXXXXXXXX  X
XXXXXXXXXXXXXXXXXXXDpXX
XXXXXXXXXXXXXXXXXXX XXX
XXXXXXXXXXXXXXXXXXX XXX
XXXXXXXXXXXXXXXXXXXXXXX