XXXXXXXXXXXXXXXXXX
XXXXXXXXXXXXXXXXXX
XXXp XXXXXXXXXXXXX
XXX  XXXXXXXXXXXXX
XXX  X  XXXXXXXXXX
XXX   p  D   XXXXX
XXXX    XXXX XXXXX
X  p  X XXXX XXXXX
Xp      XXXX XXXXX
XX       XXX XXXXX
X        XX  XXXXX
X        XX  XXXXX
X           pXXXXX
X       pXX  XXXXX
X       XXX  XXXXX
XXX     XXXXXXXXXX
XXXXXXXXXXXXXXXXXX
XXXXXXXXXXXXXXXXXX