XXXXXXXXXXXXXXXXXXXXXXXX
XXXXXXXXXXXXXXXXXXXXXXXX
XXXXXXXXXXXXXXXXXXXXXXXX
XXXXXXXXXXXXXXXXXXXXXXXX
XXXXXXXXXXXXXXXXXXXXXXXX
XX       XXXXXXXXXXXXXXX
XX       XXXXXXXXXXXXXXX
XX       XXXX      XXXXX
XX          D      XXXXX
XX       XX        XXXXX
XX       XX  XXX XXXXXXX
XX       XX  XXX XXXXXXX
XXX    XX      X XXXXXXX
XX             X XXXXXXX
XX             X XXXXXXX
X              XDXXXXXXX
X p              XXXXXXX
X                XXXXXXX
X                     XX
X                     XX
XX              XXXXXXXX
XXXXXXXXX       XXXXXXXX
XXXXXXXXXXXXXXXXXXXXXXXX
XXXXXXXXXXXXXXXXXXXXXXXX