XXXXXXXXXXX
XXXXXXXXXXX
XXXXXXXXXXX
XXXXXXX  XX
X  XXXX  XX
X p     XXX
XX X  XXXXX
X     XXXXX
X  XXXXXXXX
XXXXXXXXXXX
XXXXXXXXXXX