XXXXXXXXXXXXXXXXXXXXXXXX
XX   XXXXXXXXXXX     XXX
XX   XXXXX      p    XXX
XXp             XX XXXXX
XX   XXXXX XXXX XX XXXXX
XXX XXXXXX XXXX XX XXXXX
XXX XXXXXX XXXX XX XXXXX
XXX   XX    XXX XX XXXXX
XXX p XX  p XXX XX XXXXX
XXX   XX    XXX XX XXXXX
XXX         XXX XX XXXXX
XXX   XX    XXX XX XXXXX
XXX      XXXXXX XX XXXXX
XXX       XXXX   X XXXXX
XXX       XXXX   X XXXXX
X            X   X XXXXX
X            X    XXXXXX
X            X   XXXXXXX
X        XXp X   XXXXXXX
X      p XXXXXXXXXXXXXXX
X        XXXXXXXXXXXXXXX
XXX   XXXXXXXXXXXXXXXXXX
XXXXXXXXXXXXXXXXXXXXXXXX
XXXXXXXXXXXXXXXXXXXXXXXX