XXXXXXXXXXXXXXXX
XXXXXXXXXXXX  XX
XXXXXXXXXXXX  XX
XXX   D       XX
X    XXXXXXX  XX
X        XXXX XX
X   pX   XXXX XX
XXXXXX    XXX XX
XX  XX    XXX XX
X       X XXX XX
X       X X   XX
X        p   pXX
X             XX
XXXXX       XXXX
XXXXXXXXXXXXXXXX
XXXXXXXXXXXXXXXX