XXXXXXXXXXXXXXX
XXXXXXXXXXXXXXX
XXXXXXXXXXXXXXX
XXXX   XXXXXXXX
XXXX   XXXXXXXX
XXXX    D  XXXX
X  X   XXX XXXX
X pXX XXX   XXX
X       X   XXX
X       XXXXXXX
X p  p      XXX
XX        p XXX
XXXXXXXXX   XXX
XXXXXXXXXXXXXXX
XXXXXXXXXXXXXXX