XXXXXXXXXXXXX
XXXXXXXXXXXXX
XXXXXXXXXXXXX
XXXXXXXXXXXXX
XXX  XXXXXXXX
XXX      XXXX
XXX  X   XXXX
X  X X p XXXX
X     XXXXXXX
X     XXXXXXX
X   p XXXXXXX
XXXXXXXXXXXXX
XXXXXXXXXXXXX