XXXXXXXXXXXXXXXXXXXXX
XXXXXXXXXXXXXXXXXXXXX
XXXXXXXXXXXXXXXXXXXXX
XXXXXXXXXXXXXXXXXXXXX
XXXX     X     XXXXXX
XX D             XXXX
XX XXX XXXXX XXX XXXX
XX      XXXX XXX XXXX
XX    p XXXX XXX XXXX
XX               XXXX
XX       XXX XXX XXXX
XX       XXX XXX XXXX
XX XXX  XXXX XXX XXXX
XX XXX  XXXX X    XXX
X   XX            XXX
X         XX X     XX
X                  XX
X   XXXXXXXXXXXXXXXXX
X   XXXXXXXXXXXXXXXXX
XXXXXXXXXXXXXXXXXXXXX
XXXXXXXXXXXXXXXXXXXXX