XXXXXXXXXXXXXXXXXXX
XXXXXXXXXXXXXXXXXXX
XXXX     XXXXXXXXXX
XXXX     XXXXXXXXXX
XXXXXX X XXXXXXXXXX
XXXXXX X XXXXXXXXXX
XXXXXX X XXXXXXXXXX
X   XX    XXXXXXXXX
X             XXXXX
XX XXX XX XXX XXXXX
XX      p      XXXX
XX        p  p XXXX
XXX            XXXX
XXX       XX   XXXX
X         XX   XXXX
X         XXXXXXXXX
XXXXXXXX  XXXXXXXXX
XXXXXXXXXXXXXXXXXXX
XXXXXXXXXXXXXXXXXXX