XXXXXXXXXXXX
XXXXXXXXXXXX
XXXXXXXXXXXX
X   XXXXXXXX
X   XXXXXXXX
XX  XX   XXX
X    X   XXX
X p     XXXX
XXX    XXXXX
XXXX  XXXXXX
XXXXXXXXXXXX
XXXXXXXXXXXX