XXXXXXXXXX
XXXXXXXXXX
XXXXXXXXXX
XXXXXXXXXX
XXXXXXX   
XXXXXX   X
XX      DX
XXX  X   X
X X  X X X
X  X X XDX