XXXXXXXXXXXXXXXXXXXXXX
XXXXXXXXXXXXXXXXXXXXXX
XXXXXXXXXXXXXXXXXXXXXX
XXXX     XXXXXXXXXXXXX
XXXX     XXXXXXXXXXXXX
XXXX     D         XXX
XXXX     XXXXXXXXX XXX
XX     XXXXXXXXXXXDXXX
XX     XXX     XXX XXX
X              XXX XXX
X      XXX     XXXDXXX
X        p      XX XXX
X               XX XXX
X        p      XX XXX
X         XX XXXXX XXX
XX        XX XXXXX XXX
XX       XX        XXX
XX       XX   p     XX
XXX                 XX
XXX     XXX       XXXX
XXXXXXXXXXXXXXXXXXXXXX
XXXXXXXXXXXXXXXXXXXXXX