XXXXXXXX XXXXXXXXXX
XXXXXXXX  XXXXXXXXX
XXXXX  XX  XXXXXXXX
XXXXX      XXXXXXXX
XXXXX D     XXXXXXX
XXXX DXXXXX XXXXXXX
XXXX        XXXXXXX
XXXX      XXXXXXXXX
XXXXX   p XXXXXXXXX
XXXXXX     XX   XXX
XXXXXXX    XXX XXX 
XXXXXXX   pXX   XX 
XXXXXXX   XXXXX X  
XXXXXX    XXX   X  
XXXXXX    XX   XXXX
XXXXXXX   XX XXXXXX
XXXXXXX   XX XXXXXX
XXXXXXX   XX XXXXXX
XXXXXX  X    XXXXXX