XXX XXXXXX
XX   XXX  
XXXX  DD X
XXXXXXXXX 
XXXXXXD X 
XXXXXX    
XXXXXX    
XXXXXX X  
XXXXX  XX 
XXXXXX XX 