XXXXXXXXXXXXXXXXXX
XXXXXXXXXXXXXXXXXX
XXXXXXXXXXXXXXXXXX
XXXXXXXXXXXXXXXXXX
XXXXXXXXXXXXXXXXXX
XXXXXXXXXXXXXXXXXX
XXXXXXXXX XXXXXXXX
XXXXXXXX  XXXX XXX
XXXXXXXX   XXX  XX
XXXXXXXX X  X   XX
XXXXXXXX XXp  X   
XXXXXXXX        X 
XXXXXXXX  X   X   
XXXXXXXX  X  D  XX
XXXXX XX    X    X
XXXXX X          X
XXXXX   p X   X  X
XXX  X    XDX X DX