XXXXXXXXXXXXXX
XXXXXXXXXXXXXX
XXXXXXX XXXXXX
XXXXXXX      X
X XX XXXXX XXX
XXXX X X   XXX
XXXX X XpXXXXX
XXXX   X XXXXX
XXXX   X  XXXX
 XX  XXXX XXXX
XX      p XXXX
XX XXXX   XXXX
XX  X D  XXXXX
DX XXX  XXXXXX