XXXXXXXXXXXXXXXXX
XXXXXXXXXXXXXXXXX
XXXXXXX p  XXXXXX
XXXXXXX    XXXXXX
X    XX    XXXXXX
X          XXXXXX
X      XX XXXXXXX
XXX    X  XXX pXX
XX          D  XX
XXD    XXXXXXX XX
XXD X  XXXXXXX XX
XX D    XXXXXX XX
X          XXX XX
X             XXX
XXXX    XXXXXXXXX
XXXXXXXXXXXXXXXXX
XXXXXXXXXXXXXXXXX