XXXXXXXXXXXXXX
XX  XXXXXXXXXX
XX          XX
XXXXXXXX    XX
XXXXXXXX    XX
XXXXXXXX X XXX
XXXXXXXX X XXX
XXX   X  X XXX
XXX      D  XX
XXXXDXX  X  XX
XXXX        XX
XXXXXXXXXXXXXX
XXXXXXXXXXXXXX
XXXXXXXXXXXXXX