XXXXXXXXXXXXXXXXXXXXXXX
XX      XXXXXXXXXXXXXXX
XX      XXXXXXXXXXXXXXX
XX         XXXXXXXXXXXX
XX      XX XXXXXXXXXXXX
XXXXX XXXX XXXXXXXXXXXX
XXXXX XXXX XXXXXXXXXXXX
XXXXX XXXXDXXXXXXXXXXXX
XXXXX      XXXXX   XXXX
XXXXX      XXXXX   XXXX
XXXXX          D   XXXX
X   XXX  X XXXXX   XXXX
X   p      XXXXX   XXXX
X                 XXXXX
X          XXXXX   XXXX
X      p     XXX   XXXX
X                  XXXX
X            XXX   XXXX
X    p       XXX   XXXX
XX            XXXXXXXXX
XXXXX         XXXXXXXXX
XXXXXXXXXXXXXXXXXXXXXXX
XXXXXXXXXXXXXXXXXXXXXXX