XXXXXXXXXXXXXXX
XXXXXXXXXXXXXXX
XX  p XXXXXXXXX
XX    XXXXXXXXX
XX        XXXXX
XX    X    XXXX
X    XX    XXXX
X    XXXXXXXXXX
X        XXXXXX
X        XXXXXX
X    X XXXXXXXX
XX      XXX  XX
XX       D   XX
XXXXXXXXXXXXXXX
XXXXXXXXXXXXXXX