XXXXXXXXXXXXX
XXXXXX  XX  X
XXXXXX  X   X
XXXXX  X    X
XXXX  XXX   X
XXXXXXXXX  XX
XXXXXXXXX   X
XXXXXXXXX X X
XXXXXXXXX  XX
XXXXXXXXXX XX
XXXXXXXXX    
XXXXXXXX  XXX
XXXXXXXX   XX