XXXXXXXXXXX
X pXXXXXXXX
X      XXXX
X  XXX XXXX
X   XX XXXX
X      XXXX
X      XXXX
XX     XXXX
XX     XXXX
XXXXXXXXXXX
XXXXXXXXXXX