XXXXXXXXXXXXXX
X  XXXXXXXXXXX
X     XXX  XXX
X pX  D    XXX
XX X  XXXX XXX
XX    XXXX XXX
XX    X  X XXX
XX    X   XXXX
XX          XX
X  X   X    XX
X  X   XXXXXXX
X  XXXXXXXXXXX
XXXXXXXXXXXXXX
XXXXXXXXXXXXXX