XXXXXXXXXXXXXXXXXXXXXXX
XXXXXXXXXXXXXXXXXXXXXXX
XXXXXXXXXXXXXXXXXXXXXXX
XXXXXXXXXX XXXXXXXXXXXX
X XXXXXXXX XXXXXXXXXXXX
X XXXXXXXX      XXXXXXX
X XXXXXXXXX  XX XXXXXXX
X  XXXX XXX XX  XXXXXXX
X XXX   XXX XXDX   XXXX
X XXX XX    XX X XXXXXX
X      X XXXXX X  XXXXX
XX p X X XXXXX X XXXXXX
XX XXX   XXXXX X XXXXXX
XX  XX X XXXX    XXXXXX
XXX XXpXp XXX   XXXXXXX
XXX    XX XX    XXXXXXX
XXX   XXX XX    XXXXXXX
XX  X XXX    D XXXXXXXX
XX    X         XXXXXXX
XX          D     XXXXX
XX X   D  X XX    XXXXX
XXD   X   X    p XXXXXX
XX    XD  XXD X   XXXXX