XXXXXXXXXXXXXXXXXXX
XXXXXXXXXXXXX XXXXX
XXXXXXXXXXXXX    X 
XXXXXXXXXXX   XX   
XXXXXXXXXXXXXXXXp  
XXXXXXXXXXXXXXXXXp 
XXXXXXXXXXXXX      
XXXXXXXXXXXXX  D   
XXXXXXXXXX X   D  X
XXXXXXXXX     X   X
XXXXXXXX   X D     
XXXXXXX  XXXX XX   
XXXX    XXXXX XXXXX
XXX  XXXXXXXXXXXXXX
X   XXXXXXXXXXXXXXX
    XX  D XXXXXXXpD
XX p D        XX   
XXXXXXXXXX      D  
XXXXXXXXXXX   X    