XXXXXXXXXXXXXXXXXXXXX
XXXXXXX    XXXXXXXXXX
XXXXXXX    XXXXXXXXXX
XXXXXXX    XXXXXXXXXX
XXXXXXXXX DXXXXXXXXXX
XXXXXXXXX  XXXXXXXXXX
XXXXXXXXX  XXXXXXXXXX
XXXXXXXXX  XXXXXXXXXX
XXXXXXXXX  XXXXXXXXXX
X    XXXX  XXXXXXXXXX
X    XXXX  XXXXXXXXXX
X        p XXXXXXXXXX
X            XXXXXXXX
X            XX    XX
X    X             XX
X          XXXXXX XXX
XXXXXXXX  D      XXXX
XXXXXXXXXXXXXXXXXXXXX
XXXXXXXXXXXXXXXXXXXXX
XXXXXXXXXXXXXXXXXXXXX
XXXXXXXXXXXXXXXXXXXXX