XXXXXXXXXXXXXXX
XXXXXX    XXXXX
XXXXXX p  XXXXX
X    X    XXXXX
X      X XXXXXX
XXX    X XXXXXX
XXX         XXX
XXXX X X X  XXX
XXXX X  D   XXX
XXXX X  DXXXXXX
XXXX p   XXXXXX
XXXX    XXXXXXX
XXXX    XXXXXXX
XXXXXXXXXXXXXXX
XXXXXXXXXXXXXXX