XXXXXXXXXXX
XX  XXXX XX
XX    XXXXX
XX  X XXXXX
XX XXXXXXXX
XX XXXXXXXX
 X XXXXXXXX
XX XXXXXXXX
 X XXXXXXXX
XX XXXXXXXX
XXXXXXXXXXX