XXXXXXXX
   XXXXp
XXXX XXX
XXXX   D
  D     
XXX    D
XXX   XX
XXXXXXXX