XXXXXXXX XXXXXXXXXXXXX
XX  XXXX  XXXXXXXXXXXX
XX XXXXXX XXXXXXXXXXXX
X  XX XXX XXXXXXXXXXXX
X  D  XXX  XXXXXXXXXXX
X   XXXXXX   XXXXXXXXX
X    XXXXXXX XXXXXXXXX
XX    XXXXXX XXXXXXXXX
XXX   XXXXXX  XXXXXXXX
XXXX p XXXXXX XXXXXXX 
XX   X  XXXXX  XXXXXX 
XXX XXXDXXXXXX     XX 
XXX   X XXXXXXXXX   XX
XXXXX   XXXXXXXXXX  XX
XXXXXX  XXXXXXXXXXX  X
XXXXXX  XXXXXXXXXX   X
XXXXX   XXXX XXXXX   X
XXXXX X   X  XXXXX X X
XXXX  XXX    XXXXX  DX
XXXX XXX     XXXXXX  X
XXXX XXX   X  XXXXX  X
XXXX  XX    X   XXX  X