XXXXXXXXXXXXXXXXX
XXX   pX  XXXXXXX
XXX       XXXXXXX
XXX    XX XXXXXXX
XXp   XXXDXXXXXXX
XX    XXX XXXXXXX
XX    XXX XXXXXXX
XXX  XXXX XXXXXXX
XXX    X  XXXXXXX
XX     X  XXXXXXX
XX        D   XXX
XXp    X  X    XX
XX       XX    XX
XX   X         XX
XXXXXXXXXXX    XX
XXXXXXXXXXXXXXXXX
XXXXXXXXXXXXXXXXX