XX XXXXX
X  XXXXX
X XXX XX
XXXXXDXX
X   D DX
XXXXX   
XXXXXXX 
XXXXXXX 