XXXXXXXXXXXXXXXX
XXXX     X XXXXX
XXXXX Xp X X D D
 XXXX  X   XX XX
XXXXX XXX p   XX
XXXXX XXX     XX
XXXXX X   XX  XX
XXXXXXX   XX XXX
 XXXXXX X XXXXXX
XXXXXXXXX XXXXXX
XXXXXXXXX XXXXXX
XXXXXXXXX  XXXXX
XXXXXXXXXXXXXXXX
XXXXXXXXXXXXXXXX
XXXXXXXXXXXXXXXX
XXXXXXXXXXXXXXXX