XXXXXXXXX
XXXXX  XX
XX     XX
Xp XXX XX
X  Xp  XX
X  X  XXX
X  XXXXXX
XXXXXXXXX
XXXXXXXXX