XXXXXXXXXX
XX  XXXXXX
XX  XXXXXX
X   XXXXXX
X   XXXXXX
X   XX  XX
X       XX
XX  XXXXXX
XXXXXXXXXX
XXXXXXXXXX