XXXXXXXXXXXXX
XXXX  pX   XX
XXXXXX X  XXX
 XX D     XXX
XXX XXXXX XXX
X   XXXXX XXX
XXX XXXXX   X
XX  XXXXX X  
XX XXXXXX XD 
XX  XXXXX   X
XXXXXXXX   XX
XXXXXXXX  pXX
XXXXXXXXXXXXX