XXXXXXXXXXX
XX  XXXXXXX
XX  XXXXXXX
XXX XXXXXXX
XXX XXX  XX
X   X    XX
X     XX XX
X       XXX
XXXXXXXXXXX
XXXXXXXXXXX
XXXXXXXXXXX