XXXXXXXXXXXXXXXXXX
X   XXX       XXXX
XX  XXX     X  XXX
XX  XXX  X  X  XXX
X     X  X XX    X
XXX XXX    XXXXXXX
XXX  XX     XXXXXX
XXXX X         XXX
XXXX   XX XXX  XXX
XXXXX DXX XXX XXXX
XXXXX  XX  XX XXXX
XXXXX  X   XX XXXX
XXXXXX X   XX   XX
XXXXX  XX XXXXXXXX
XXX  D DXXXXXXXXXX
XXX  XX XXXXXXXXXX
X    pXXXXXXXXXXXX
X XXXXXXXXXXXXXXXX