XXXXXXXXXXXXXXXXXX  
XXXXXXXXXXXX      X 
XXXXXXXXXXX  XXXX XD
XXXXXXXXXXXX XXXX   
XXXXXXXXXXXXXXXXXXX 
XXXXXXXXXXXXXXXX    
XXXXXXX      XXXXX  
XXXXXXX XX X  X  X X
XXXXXXXXXXXXX      X
XXXXXXXXXXXXXXXXXX  
XXXXXXXXXXXXXXXXXX  
XXXXXXXXXXXXXXXXXXDX
XXXXXXXXXXXXX       
XXXXXXXXXXXXXXX  p  
XXXXXXXXXXXXXXXXX   
XXXXXXXXX    XX   X 
XXXXXXXXX XX    XXX 
XXXXXXX   XXX  XXXX 
XXXXXXX XXXXXXXXXXX 
XXXXXXX XXXXXXXXXXX 