XXXXXXXXXXXXXXXXXXX
XXXXXXXXXXXXXXXXXXX
XXXXXXXXXXXXXXXXXXX
XXXXXXXXXXXXXXXXXXX
XXXXXXXXXXXXXXXXXXX
XXXXXXXXXXXXXXXXXXX
XXXXXXXXXXXXXXXXXXX
X     XXXXXXXXXXXXX
X      XXXXXXXXXXXX
X       XXXXXXXXXXX
X             XXXXX
XX            XXXXX
X     p  p    X  XX
X                XX
X               XXX
X       XXXXXXXXXXX
X      XXXXXXXXXXXX
XXXXXXXXXXXXXXXXXXX
XXXXXXXXXXXXXXXXXXX