XXXXXXXX
XXXXXXXX
 XXXX XX
XXXXX pX
XXXXX  X
XXXXX  X
XXXXX   
XXXXX   