XXXXXXXXXXXXXXXXXXX
XD XX X XXXXXXXXX  
XX  X X  XXXXXXX  X
X   X XX XXXXXXX  X
XX  X XXXXXXXXXXXXX
X   X  XXXXXXXXXXXX
X     XXXXXXXXXXXXX
X X  XXXXXXXXXXXXX 
X X XXXXXXXXXXXXXXX
X   XXXXXXXXXXXXXXX
XX  XXXXXXXXXXXXXXX
XX  XXXXXXXXXXXXXXX
XX  XXXXXXXXXXXXXXX
XX  XXXXXXXXXXXXXXX
XX   XXXXXXXXXXXXXX
XXXX XXXXXXXXXXXXXX
XXXX XXXXXXXXXXXXXX
XXX  XXXXXXXXXXXXXX
XXX  XXXXXXXXXXXXXX