XXXXXXXXX
XXXXXXXXX
X  XXXXXX
X      XX
X  XXX XX
X   X  XX
X p X  XX
XXXXXXXXX
XXXXXXXXX