XXXXXXXXXXXXXXXXXXXXX
XXXXXXXXXXXXXXXXXXXXX
XXXXXXXXXXXXXXXXXXXXX
XXXXXXXXXXXXXXXXXXXXX
XXXXXXXXXXXX      XXX
X     XX D        XXX
X     XX XXXXXX XXXXX
X     XX XXXXXX XXXXX
X     X   XXXXX XXXXX
X         XXXXX XXXXX
Xp    X  pXXXXX XXXXX
X     X   XXXXX XXXXX
X     X    XXXX XXXXX
X     X    p    XXXXX
X  p       p    XXXXX
X               XXXXX
X               XXXXX
XX       p   DXXXXXXX
XX   XX     XXXXXXXXX
XXXXXXXXXXXXXXXXXXXXX
XXXXXXXXXXXXXXXXXXXXX