XXXXXXXXXX
XXXXXX  XX
XXXX    XX
XX      XX
X    DXXXX
XXX  pXXX 
XXXX  XX  
XXX       
XX        
XXXXXXX   