XXXXXXXXXXX
XXX  XXXXXX
XXX  XXXXXX
XXXX XX  XX
XXX p    XX
XXX p   XXX
XX   XXXXXX
XX    XXXXX
XXX   XXXXX
XXXXXXXXXXX
XXXXXXXXXXX