XXXXXXX  X
XXXXXXX XX
XXXXX   XX
XX X  XXXX
XX X XXXXX
X    XXXXX
XXXX XXXXX
XXXX     X
XXXX      
X XX     X