XXXXXXXXXXX
XX  XXXXXXX
XX       XX
XXXD  XX XX
XXXD  XX XX
X  XX XX XX
X    XXX XX
XXXXXXX  XX
XXXXXXX  XX
XXXXXXXXXXX
XXXXXXXXXXX