XXXXXXXXXXXXXXXXXX
XXXXXXXXXXXXXXXXXX
XX   XXXXXXXXXXXXX
XX   XXXXXXXXXXXXX
XXX  XXXXXXXXXXXXX
XXX  XXXX  p XXXXX
XXX  XXXXp   XXXXX
XX   XXXX    XXXXX
XXp     XXX XXXXXX
XX          XXXXXX
X     p     XXXXXX
X           XXXXXX
X               XX
X               XX
Xp     XXXXXXX  XX
XX     XXXXXXXXXXX
XXXXXXXXXXXXXXXXXX
XXXXXXXXXXXXXXXXXX