XXXXXXXXXXXX
X   XXXXXXXX
X   D XXXXXX
XX XX   XXXX
XX XX   XXXX
XX XXp  XXXX
XX XX  XXXXX
XX XX  XXXXX
X  X   XXXXX
X  X   XXXXX
XXXXXXXXXXXX
XXXXXXXXXXXX