XXXXXXXXXX
XXXXXX  XX
X  XXX  XX
X  XXXX XX
X  XXXX XX
X      XXX
X  XX  XXX
XX     XXX
XXXXXXXXXX
XXXXXXXXXX