XXXXXXXXXXXXXXXXXXXXX
XXXXXXXXXXXXXXXXXXXXX
XXXXXXXXXXXXXXXXXXXXX
XXXXXXXXXXXXXXXXXXXXX
XX  XXXXXXXXXXXXXXXXX
XXp       D    XXXXXX
XX  XXXXXXXXXX XXXXXX
XX  XXXXXXXXXX XXXXXX
XX         XXX XXXXXX
XX         XXX XXXXXX
X        XXXXX XXXXXX
X    X p  XXXX XXXXXX
X          XXX XXXXXX
X                XXXX
X                XXXX
XXX X          XXXXXX
XXX D     p    XXXXXX
XXXXX    XXXXXXXXXXXX
XXXXXXXXXXXXXXXXXXXXX
XXXXXXXXXXXXXXXXXXXXX
XXXXXXXXXXXXXXXXXXXXX