XXXXXXXXXXXXXXX
XXXXXXXXXXXXXXX
XXXXXXXXXXXXXXX
XXXXXXXXXXX  XX
XXXX  XXX    XX
XXXX  XXXDXX XX
XXXX  XX  XX XX
X         XX XX
X    p     X XX
X      X     XX
X   p  X    XXX
XX     XXXXXXXX
XXX   XXXXXXXXX
XXXXXXXXXXXXXXX
XXXXXXXXXXXXXXX