XXXXXXXXXXXXXX
XXXXXXXXXXXXXX
XXXXXXXXXXXXXX
XX   XXXXXXXXX
XX         XXX
X   XXXXXX XXX
X   XXXXXX XXX
X   XXXXXX XXX
X      XXX XXX
XX     XX   XX
XXX         XX
XXX    XX   XX
XXXXXXXXXXXXXX
XXXXXXXXXXXXXX