XXXXXXXXXXXX
XX  XXXXXXXX
XX  XXXXXXXX
XXX XXXXXXXX
X     XX  XX
X     D   XX
XXX   XX  XX
X    XX   XX
X         XX
XX   XXXXXXX
XXXXXXXXXXXX
XXXXXXXXXXXX