XXXXXXXXXXXXXXXXX
X    XXXX   XXXXX
X    XXXX   XXXXX
X           XXXXX
X    XXXX   XXXXX
XX   XXXXX XXXXXX
XX   XXXXX XXXXXX
XX      XX XXXXXX
XX       X XXXXXX
XX  X    X XXXXXX
XX  D     XXXXXXX
XX  D     XXXXXXX
XXX XX    XXXXXXX
XXX XXXX    XXXXX
XXX         XXXXX
XXXXXXXXXXXXXXXXX
XXXXXXXXXXXXXXXXX