XXXXXXXXXXX
XXXXXXXXXXX
X  XX  XXXX
X      XXXX
XX  XX XXXX
X    X   XX
X        XX
X     XXXXX
X  XXXXXXXX
XXXXXXXXXXX
XXXXXXXXXXX