XXXXXXXXXXXXXXXXXXXXXXX
XXXXXXXXXXXXXXXXXXXXXXX
XXXXXXXXXXXXXXXXXXXXXXX
XXXXXXXXXXXXXXXXXXXXXXX
XXXXXXXXXXXXXXXXXXXXXXX
XXXX     XXXXXXX  pXXXX
XXXX     XXXXXXX   XXXX
XXXX               XXXX
XXXX X XXXXXXXXX   XXXX
X      X    XXXXX    XX
X      X    XXXXX    XX
X                    XX
X                X   XX
X      XDX XX   XXX XXX
X                  XXXX
X          D    XXXXXXX
X               XXXXXXX
X               XXXXXXX
XX           p  XXXXXXX
XXXXXXX        XXXXXXXX
XXXXXXXXXXXXXXXXXXXXXXX
XXXXXXXXXXXXXXXXXXXXXXX
XXXXXXXXXXXXXXXXXXXXXXX