XXXXXXXXXXXXXXX
XXXXXXXXXXXXXXX
XXXXXXXXXXXXXXX
XXXXXXXXXX   XX
XXXXX        XX
XXXX    XX   XX
X pp     XX XXX
X          XXXX
XXDX     XXXXXX
XX X     XXXXXX
XX X     XXXXXX
XX      XXXXXXX
XXXX   XXXXXXXX
XXXXXXXXXXXXXXX
XXXXXXXXXXXXXXX