XXXXXXXXXXXXXXXX
XXXXXXXXXXXXXXXX
XXXXXXXXXXXXXXXX
X    XXXXXX   XX
X        XX   XX
XXX X       XXXX
X   X    XXXXXXX
X    XXXXXXXXXXX
X      XXXXXXXXX
XXX    pXXXX  XX
XX            XX
XX    XXXXXX  XX
XX           XXX
XX    XXXXXXXXXX
XXXXXXXXXXXXXXXX
XXXXXXXXXXXXXXXX