XXXXXXXXXXXXXXX
XXXXXXXXXXXXXXX
XXXXXXXXXXXXXXX
XXXXXXXXXX   XX
XXXXXXXXXX XXXX
    XXXXX  XXXX
XX XXXXXX  XXXX
XX XXXXXX    XX
XX XXX X    X X
XX XXX   X    X
XX  XX      DXX
XXX XXXX       
XXX DXX       X
XXXX   D  D X X
X XXX    X     