XXXXXXXXXXXXXXXXXXX
Xp XXXXXXXXXXXXXXXX
X  XXXXXXXXXXXXXXXX
X  XXXXXXXXXXXXXXXX
XX XXXXXXXXXXXXXXXX
XX    XXXXXXXXXXXXX
XX    XXXp    XXXXX
XX   XXXX    pXXXXX
XX   XXXX     XXXXX
X             XXXXX
X     XXX     XXXXX
X         X XXXXXXX
X            XXXXXX
X     D      XXXXXX
X     D      XXXXXX
XX   XX     XXXXXXX
XXp  XXXXXXXXXXXXXX
XXXXXXXXXXXXXXXXXXX
XXXXXXXXXXXXXXXXXXX