XXXXXXXXXXXXXXXXXXXXX
XXXX     XX XX XXXXX 
XXXXpXXX XX     X XX 
XX   XXXp   XX       
XXpXXXXXXXXXXXXXXX   
XXXXXXXXXXXXXXXXXXXX 
XXXXXXXXXXXXXXXXXX   
XXXXXXXXXXXXXXX    XX
XXXXXXXXXXXXX    XXXX
XXXXXXXXXXXX  XXXXXXX
XXXXXXXX     XXX   XX
XXXXXXXXXXX          
XXXX        XXXX    X
XXXXX XXXXXXXXXXXX   
XXXXXXXX XXXXXXXXXX X
XXXXXXX   XXXXXXXXXXX
XXXXXXXXX            
XXXXXXXXXXX  XX  pXXX
XXXX  XXXXXXXXX      
XX     XXXXXXXX XXXX 
XX XXX XXXXXXXXX XXXX