XXXXXXXXXXXXXXXXXXXXX
XXXXXXXXXXXXXXXXXXXXX
XXXXXXXXXXXXXXXXXXXXX
XXXXXXXXXXXXXXXXXXXXX
XXXXXXXXXXXXXXXXXXXXX
XXXXXXXXXXXXXXXXXXXXX
XX     XXXXXXXXXXXXXX
XX     XXXXXXXXXXXXXX
XX      XXXXXXXXXXXXX
XX      XXXXXXXXXXXXX
XX           XXXXXXXX
XX           XXXXXXXX
X            X   XXXX
X       XX   X   XXXX
X       XX   X   XXXX
X                XXXX
X                XXXX
X         XXXX   XXXX
XXXX      XXXXXXXXXXX
XXXXXXXXXXXXXXXXXXXXX
XXXXXXXXXXXXXXXXXXXXX