XXpXXXXXXXXXXXXXXX
XXXXXXXXXXXXXXXXXX
  XXXXXXXXXXXXXXXX
X XXXXXXXXXXXXXXXX
X   XXXXXXXXXXXXXX
XXX     XXXXXXXXXX
XXX  p    D  XXXXX
XXX XXXXXXXX XXXXX
XX  XXXXXXX  XXXXX
X  XXXXXXX  XXXXXX
XD XXXXXXX XXXXXXX
XXXXXXXXXX  XXXXXX
XXXXXXXXXX  XXXXXX
 XXXXXXXX  XXXXXXX
X XXXXXXX  XXXXXXX
X XXXXXXXX XXXXXXX
Xp  XXXXXX XXX XXX
X X XXXXXXDXX  X  