XXXXXXXXX
XXXXXXXXX
XXXXXXXXX
XXXXX XXX
XXXXX XXX
XXXXX    
XXX      
XX  DX  X
XXXXX  D 