XXXXXXXXXXXXXXXX
XXXXXXXXXX   XXX
XXXXXX       XXX
XXXXXX XXX   XXX
XXX  X XXXX XXXX
XXX  X XXXX XXXX
XXX pX    XDXXXX
XXX  X     XXXXX
XXX  X    XXXXXX
X    X X XXXXXXX
X        XXXXXXX
X        XXXXXXX
X  p    XXXXXXXX
XXXXX   XXXXXXXX
XXXXXXXXXXXXXXXX
XXXXXXXXXXXXXXXX