XXXXXXXXXXXXXX
X  XXXXXXXXXXX
X  X   XXXXXXX
XX X      XXXX
XX X   X  XXXX
XX X      XXXX
XX     X  XXXX
XX X   XXXXXXX
X      XXXXXXX
X      XXXXXXX
X      XXXXXXX
XXXXX  XXXXXXX
XXXXXXXXXXXXXX
XXXXXXXXXXXXXX