XXXXXXXXX
X   XXX X
X  XXXXD 
X  XXXX X
XX XXXX X
XX XXX  X
XX  XXXXX
XXD XXXXX
X  XXXXXX