XXXXXXXXXXXXXXXXXXXXXXX
XX     XXXXXXXXXXXXXXXX
XX     XXXXXXXXXXXXXXXX
XX     XXXXXXXXXXXXXXXX
XX     XXXXXXXXXXXXXXXX
XX     XXXXX  XXXXXXXXX
XX   p X      XXXXXXXXX
XXXX       X  XXXXXXXXX
XXXXXXXX   XX XXXXXXXXX
X      XXXXXX XXXXXXXXX
X      XXXXXX XXXXXXXXX
X p                XXXX
X             DDDX XXXX
X             XX X XXXX
XXX  XXX      X    XXXX
XXX DXXXXXXXX      XXXX
XX    XXXXXXXXXXXX XXXX
XX    XXXXXXXXXXXX XXXX
XX   pXXXXXXXXXX     XX
XX        D          XX
XX    XXXXXXXXXX     XX
XXXXXXXXXXXXXXXXXXXXXXX
XXXXXXXXXXXXXXXXXXXXXXX