XXXXXXXXXXXXXXXXXXXX
XXXXXXXXXXXXXXXXXXXX
XXXXXXXXXXXXXXXXXXXX
XXXXXXXXXXXXXXXXXXXX
X  XXXXXX  XXXXXXXXX
X          XXXXXXXXX
X     XXX       XXXX
X     XXX  XXXX XXXX
X     XXX  XXXX XXXX
Xp  p   XXXXXXX XXXX
X         XXXXX XXXX
XX         XXX  XXXX
XX   D    p     XXXX
XXX XXX  p XXXX XXXX
XXX XXXX  ppX    XXX
XXX X       X    XXX
XXXD  p p   XXXXXXXX
XXXXXXXX p  XXXXXXXX
XXXXXXXXXXXXXXXXXXXX
XXXXXXXXXXXXXXXXXXXX