XXXXXXXXXXXXXX
XX   XXXXXXXXX
XX  p      XXX
XX   XXX   XXX
XXXD   X   XXX
XXX  p X   XXX
XXXX   XX  XXX
XXXXX XXX  XXX
XX    XXX  XXX
X          XXX
X          XXX
X      XXXXXXX
XXXXXXXXXXXXXX
XXXXXXXXXXXXXX