XXXXXXXXXX
XXX  X  XX
XXX     XX
XXX    XXX
XX     XXX
X    X XXX
X    p XXX
XX     XXX
XXXXXXXXXX
XXXXXXXXXX