X XXXXXXX
X XX  X  
         
XX XX    
D   XXXXX
XXX      
XXXXXXX  
XXXXXXXXX
XXXXXXXXX