XXXXXXXXXXXXXXXXXX
XXXXXXXXXXXXXXX XX
XXXXXXXXXXXXXXXpXX
XXXXXXXXXXXXXXX XX
XXXX XXXXXXXXXX XX
XX   XXXXXXXX  pXX
XX   XXXXXXXX  XXX
X      XXXXXX XXXX
X  XXX XXXX   XXXX
X  X X XXXXX  XXXX
 X   X XXXXX   XXX
XXX  X  XXXX X    
XXX  X  XXXX   XX 
XXX     XXXX XDXX 
XX     D     X    
XXX     X  XXX   X
XXX        XXX X X
XXXXX    X XX pX X