XXXXXXXXXXXXXXXXXXXXXXXX
XXXXXXXXXXXXXXXXXXXXXXXX
XXXXXXXXXXXXXXXXXXXXXXXX
XXXXXXXXXXXXXXXXXXXXXXXX
XX       XXXXXXXXXXXXXXX
XX  p    XXXXXXXXXXXXXXX
XX p     XXXXXXXXXXXXXXX
XX       XXXXXXXXXXXXXXX
XX       XXXXXXXXXXXXXXX
XX    p  XXXXXXXXXXXXXXX
XX       X   XXXXXXXXXXX
XXX          XXXXXXXXXXX
XXX          XXXXXXXXXXX
XXXXX  X       XXXXXXXXX
XXXXX             XXXXXX
XXX               XXXXXX
XXX      XXX   XXXXXXXXX
XXX                XXXXX
XXX      XXX   X    XXXX
XXX          XXX    XXXX
XXX        DD       XXXX
XXX     XXXXXXXX   pXXXX
XXXXXXXXXXXXXXXXXXXXXXXX
XXXXXXXXXXXXXXXXXXXXXXXX