XXXXXXXXXXXXXX
XXXXXXXX  XXXX
XXXXXXXX  XXXX
XX  XXXX  XXXX
XX     XX XXXX
XX  XX XX XXXX
X    p XX XXXX
X      XX XXXX
X          XXX
X          XXX
XX         XXX
XX  XXXXXXXXXX
XXXXXXXXXXXXXX
XXXXXXXXXXXXXX