XXXXXXXXXXXXXXXXXXXXX
XXXXXXXXXXXXXXXXXXXXX
XXXXXXXXXXXXX      XX
XXXXXXXXXXXXX      XX
XXXXX      XX  p   XX
XXXXX      XXXXX XXXX
XXXXX      XXXXX XXXX
XXXXX           XXXXX
XXXXX  p   XXXXXXXXXX
XXXXX      XXXXXXXXXX
XXXXXXXX XXXXXXXXXXXX
XXXXX  X    XXXXXXXXX
XXXXX     p    XXXXXX
XXX          X XXXXXX
X           XX XXXXXX
X          XXX XXXXXX
XXXXX            XXXX
XXXXX            XXXX
XXXXX     XXXXXXXXXXX
XXXXXXXXXXXXXXXXXXXXX
XXXXXXXXXXXXXXXXXXXXX