XXXXXXXXXXXXXXXX X
XXXXXXXXXXXXXXXXXX
XXXXXXXXXXXXX  XXX
XXXXXXXXXXXXX  XXX
XXXXXXXXXXXXX  XXX
XXXXXXXXXXX D  XXX
XXXXXXXXX   XXXXXX
XXXXXXXDXX  XXXXXX
XXXXXX  XX  XXXXXX
XXXXXXX  XD XXXXXX
XXXXX Xp   XXXXXXX
XXXX  X    XXXXXXX
XXXX  X  X XXXXXXX
XXXX XX    XXXXXXX
  XX XXX    XXXXXX
 XXX      p XXXXXX
XXXXXX      XXXXXX
XXXXXX     DXXXXXX