XXXXXXXXX
XXXX   XX
XXXX   XX
XXXXX  XX
XXXX   XX
XXX D  XX
XXX  XXXX
 XX  XXXX
XXXX XXXX