XXXXXXXXXXXX
XXXXXXXXXXXX
X  XXXXXXXXX
X  XX  XXXXX
X  XX p  XXX
X   XX X XXX
X   XX X XXX
X     XX XXX
X   XXX   XX
XX        XX
XXXXXXXXXXXX
XXXXXXXXXXXX