XXXXXXXXXX XX
XXXXXXXXXX XX
 XXXXXXXXX  X
XXXXXXXXXX  X
XXXXXXXXXX XX
XXXXXXXXXX XX
 XXXXXXXXX XX
XXXXXXXXXX  X
XX  XXXXXX  X
XXX XXXXXX   
XXX XXXXX  X 
XXXp  XX  XX 
X     XX  XX 