XXXXXXXX XXXXXXXXXXXXXXX
XXXXXp  X    X XXXX XXXX
 XXXXX XXX   X XXXX XXXX
XXXXX  XXXX  X XX   XXXX
X XXX    XX      D XXXXX
X XXXX   XXX      XXXXXX
XXXXXXXX  XX    pXXXXXXX
 XXXXXXXXX          XXXX
XXXXXXXXXX  XX  XXX XXXX
XXXXXXXXXXX XX   XX  XXX
XXXXXXXXXXX XX   X   XXX
XXXXXXXXXXXX        XXXX
XXXXXXXXXXXXX p XX XXXXX
 XXXXXXXXXXXXp XXX XXXXX
XXXXXXXXXXXXX  XXX XXXX 
XXXXXXXXXXXX   XXX XX D 
XXXXXXXXXXXX   XXX XXXXp
XXXXXXXXXXX    XXX XXXXp
XXXXXXXXXXX X XXX  XX   
XXXXXXXXXXX    XX XXX XX
XXXXXXXXX    XXXX XX  XX
XXXXXXXXXX X XXXX XX XXX
XXXXXXXXXXXXXXXXX XX XXX
XXXXXXXXXXXXXXXXXXXXXXXX