XXXXXXXX
XXXXXXXX
X  XXXXX
X   XXXX
XX  XXXX
XX  XXXX
XXXXXXXX
XXXXXXXX