XXXXXXXXXXXXXXXX
XXXXXXXXXXXXXXXX
XXXXX    XXXXXXX
XXXX     XXXXXXX
X    XXDXXXXXXXX
X    XX XXXXXXXX
X    XX XXXXXXXX
X    XXDXXXXXXXX
X     p XXXXXXXX
Xp      XXX   XX
X             XX
X        XX   XX
X        XXX XXX
X           XXXX
XXXXXXXXXXXXXXXX
XXXXXXXXXXXXXXXX