XXXXXXXXXXXXXXXX
XXXXXXXXXXXXXXXX
X   XXXXXXXXXXXX
X  XXXXXXXXXXX X
X   XX XXX  X  X
XXD   p XXpXXX X
XX  X XXXX XXX X
XX    XXXX XXX X
X   X XXXX XXX X
X     XXXX XX  X
XXD  XXXXX DX  X
  X  XXXXXX   XX
X X  XXX  X   XX
X    XXX XX   XX
X    XXX XX   XX
X   XXX     X XX