XXXXXXXXXXXXXXXXXXX
XXXXXXXXXXXXXXXXXXX
XXXXXXXXXXXXXXXXXXX
XXXXXXXXXXXXXXXXXXX
XXX     XXXXXXXXXXX
XXX        XXXXXXXX
XXX     XX XXXXXXXX
X   X XXXX XXXXXXXX
X        X XXXXXXXX
X        XDXXXXXXXX
XX         XXXXXXXX
XX    X    XXXXXXXX
XX    p          XX
XXX        XX    XX
XXX    X         XX
XX           XXXXXX
XX p         XXXXXX
XXXXXXXXXXXXXXXXXXX
XXXXXXXXXXXXXXXXXXX