XXXXXXXXXXXXXXXX
XXXXXX   XXXXXXX
XXX  D   XXXXXXX
X    XX XXXXXXXX
Xp   XX XXXXXXXX
X    XX XXXXXXXX
X  p XX XXXXXXXX
X    XXDXXXXXXXX
XX   XX XXXXXXXX
XX          XXXX
X      X    XXXX
X          XXXXX
X          XXXXX
X          XXXXX
XXXXXXXXXXXXXXXX
XXXXXXXXXXXXXXXX