XXXXXXXXXXXXXXXXX
XXXXXXXXXXXXXXXXX
XX  XXXXXXXXXXXXX
XX      p XXXXXXX
XX  X    DXXX  XX
XXX           pXX
XXXXXXXD pXXX  XX
XXXXXXX   XXX  XX
XX   p         XX
XX p      XXX  XX
XX  ppX X XXXX XX
XXXXXXX    XXX XX
XXXXX      XXXDXX
XXXXX         XXX
XXXXX    XXXXXXXX
XXXXXXXXXXXXXXXXX
XXXXXXXXXXXXXXXXX