XX XXXXXXXXXXXXXXXXXXXX
X     XXXXXXX XXXXXXXXX
XXX   XXXXX   XXXXXXXXX
X      X    XXXXXXXXXXX
XXX  XXX XXXXXXXXXXXXXX
XXX  XXX XXXXXXXXXXXXXX
XXX  XXX  XXXXXXXXXXXXX
XXXD XXXX DXXXXXXXXXXXX
XXX       XXXXXXXXXXXXX
XXX X XX XXXXXXXXXXXXXX
XXX   XX   XXXXXXXXXXXX
XXX   X  X  XXXXXXXX XX
XXX   X  X  XXXXXXXX   
XXXX  XX   XXXXXXXXXX  
XXXX   X    pXXXXXXXX X
X         XXp XXXXXX  X
XX      X XXX XXXXXX XX
X    D  X XXX XXXXXX  X
X  X       XX XXXXXXX  
XXXX    XXXXX XXXXXXXXX
XXX      XXX   XXXXXXXX
XXXDX     XX XXXXXXXXXX
XXX X     XX XXXXXXXXXX