XXXXXXXXXXXXXXXXXXXX
XXXXX XXXXXX  XXXXXX
XXXXXXXXXXXXXXXXXXXX
XXXXXXXXXXXXXXXXXXXX
XXXX XXXXXXXXXXXXXXX
XXX  XXXXXXXXXXXXXXX
XXXXDXX XXXXX  XXXXX
XXXX XX  XXXXX XXXXX
XXXX         X  XX  
XXXX XXXXXXX XX  p  
XXXXXXXXXXXX        
XXXXXXXXXXX         
XXX  XXXX   DXXXX   
XXX         XXXXXXX 
XX  XX    X  XXXXXX 
XXXX  XXXX       XX 
XXXX       X        
XXXX XXX XXXXXX     
XXXX X    XXXXXXXDD 
XXXXXX XX XXXXXXXXXX