XXX XXXXXXXXXXXXXX
XXX  XX     XXX XX
XXX    D   XXX  XX
XXXX X     XXXX XX
XXXX   X   XXXX XX
XXXXp XXX  XXXX  X
XXXX  XX   XXXX  X
XXX        XXX  XX
XXX p    X XXX   X
XXX XX   X XXXX XX
XXX X      XXXX XX
XXXXXX   X XXXX  X
X XXXX     XXXXX X
XXXXXX X  XXXXXX X
XXXXXX XX XXXXXXXX
XXXXXXXXXXXXXXXXXX
XXXXXXXXXXXXXXXXXX
XXXXXXXXXXXXXXXXXX