XXXXXXXXXXXXXXX XXXXXXX
XXX    X XXXXX XXXXX XX
XXXX   X XXXX  XXX     
XXX                    
X  X     XXXX XXXXX  XX
X  XX X   XXX   XXXX XX
XX XX  X D XXX  XXXX XX
X  XXX    XXX   XXXX XX
Xp  XX  XXX  DXXXXX  XX
XXX XX      XXXXXXX  XX
XXX X   XXXXXXXXXXX  XX
XXX    XXXXXXXXXXXX XXX
XXX     XXXXXXXXXX  XXX
XXX   X XXXXXXXX    XXX
XXX Xp                 
XXX   X  XXXXXXXX  XXXX
XXX X   XXXXXXXXX    XX
XXX X    XXXXXXXXXX  XX
XXX      XXXXXXXXX  XXX
XXXX  X  XXXXXXXXXXXXXX
XXX  p  pXXXXXXXXXXXXXX
XXX      XXXXXXXXXXXXXX
XX   X  XXXXXXXXXXXXXXX