XXXXXXXXXXXXXXXX
XXXXXXXXXXXXXXXX
XX  XXXXXXXXXXXX
XX     XXXXXXXXX
XX  XX  XXXXXXXX
XXX XXp     XXXX
XXX XX  XXX XXXX
XXX XX  XXX XXXX
XX      XXX XXXX
X       XXX XXXX
X    p   XX XXXX
X            XXX
X            XXX
XX  X   XXXXXXXX
XXXXXXXXXXXXXXXX
XXXXXXXXXXXXXXXX