XXXXXXXXX XXXXXX
XXXXD XXXX   XXX
X XX XXXX    DXX
X DX  XXX  X XXX
X  XX  XXX X XXX
X     XXXXXX  XX
X   XXXXXXXX  XX
XXX   XXXXXXX XX
XXXXX  XXXXXXXXX
XXXXXX XXXXXXXXX
XXXXXX XXXXXXXXX
XXXXXXXXXXXXXX  
XXXXXXXXXXXXXp X
XXXXXXXXXXXXX XX
XXXXXXXXXXXX   X
XXXXXXXXXXX  XXX