XXXXXXXXXXXXXXXXX
XXXX  XXXXXXXXXXX
XXXX          XXX
XXXX  XXXXXXX XXX
XXXXX XXXXXXX XXX
XX    XXXXXXX XXX
XX    XXXXXXX XXX
XX      XXXXX XXX
XX  X   XXXXX XXX
XX      XXXp   XX
XX  X          XX
XX   XX p X    XX
XXX  XX   X   XXX
XX p          XXX
XX          XXXXX
XXXXXXXXXXXXXXXXX
XXXXXXXXXXXXXXXXX