XXXXXXXXXXXXXXXXXXXXXXX
XXXXXXXXXXXXXXXXXXXXXXX
XXXXXXXXXXXXXXXXXXXXXXX
XXXXXXXXX   XXXXXXXXXXX
XXXXXXXXX   XXXXXXXXXXX
XXX  p XX         XXXXX
XXX    XX   XXXXX XXXXX
XXX    XXX XXXXXX XXXXX
XXX    XXX XXXXXX XXXXX
XXX    XXX XXXXXX XXXXX
XX      XX XXXXXX XXXXX
XX      X  XXXXXX XXXXX
XX         XXXXXX XXXXX
XX                XXXXX
XX       p  p     XXXXX
XX            X     XXX
XX          XXX     XXX
XX               p  XXX
XX         XXXX     XXX
XX  p      XXXXXXXXXXXX
XX         XXXXXXXXXXXX
XXXXXXXXXXXXXXXXXXXXXXX
XXXXXXXXXXXXXXXXXXXXXXX