XXXXXXXXXXXXXXXXXXXX
XXXXXXX  X XX  XXXXX
XXXXXXX     X XXXXXX
XXXX    X      XXXXp
XXXXXXXXXX         X
XXXXXXXXXXX XXXXXX  
XXXXXXXXXXXXXXXXXXX 
XXXXXXXXXXXXXXX     
XXXXXXXXXXXXXXX  XXX
XXXXXXXXXXXXXXX   XX
XXXXXXXXXXXXXXXXX   
XXXXXXXXXXXXXXXXXXXp
XXXXXXXXXXXXXXXXXXX 
XXXXXXXXXXXXXXXXXXX 
XXXXXXXXXXXXXXXXXXXX
XXXX   XXXXXXXXXXXXX
XXXX X       XXXXX  
XXX XX   XXX      DX
XXX       XX X X DXX
XXX XX XXD   XXXXXXX