XXXXXXXXXXXXXXXXXX
X  XX   XXXXXXXXXX
X  XX   XXX     XX
X p       D     XX
Xp XX   XXXX  XXXX
XX XXX  XXXX  XXXX
XX   X   XXX  XXXX
XX   X   XXX DXXXX
X       pXXX  XXXX
X        XXX  XXXX
Xp    X  XXX  XXXX
X      p  X   XXXX
X    p    X   XXXX
X         X   XXXX
X        XX   XXXX
XXX     XXXXXXXXXX
XXXXXXXXXXXXXXXXXX
XXXXXXXXXXXXXXXXXX