XXXXXXXXXXXXXXXXXXXXXXX
XXXXXXXXXXXXXXXXXXXXXXX
XXXXXXXXXXXXXXXXXXXXXXX
XXXXXXXXXXXXXXXXXXXXXXX
XXXXXXXXXXXXXXXXXXXXXXX
XXXXXXXXXXXXX   XXXXXXX
XXXXXXXXXXXXX   XXXXXXX
XXXX      XXX   XXXXXXX
XXX       XXX   XXXXXXX
XXX         X   XXXXXXX
XXXXXXX XXXDXX XXXXXXXX
XXX      XX XX XXXXXXXX
XXXp         X XXXXXXXX
XXX      X   X     XXXX
XXXXXX             XXXX
XXXXXXXXXX   X   p XXXX
XXXXXXXX       XXXXXXXX
XXXXXXXX      XXXXXXXXX
XXXXXXXXp     XXXXXXXXX
XXXXXXXXXXXXXXXXXXXXXXX
XXXXXXXXXXXXXXXXXXXXXXX
XXXXXXXXXXXXXXXXXXXXXXX
XXXXXXXXXXXXXXXXXXXXXXX