XXXXXXXXXX
XXXXXXXXXX
XXX  XXXXX
XXX  XXXXX
X    XXXXX
X     XXXX
XXXX  XXXX
XXXX  XXXX
XXXXXXXXXX
XXXXXXXXXX