XXXXXXXX
XXXXXXXX
X pXXXXX
X     XX
X  X  XX
X  XXXXX
XXXXXXXX
XXXXXXXX