XXXXXXXXXXXXXXXXXXXXXXX
XXXXXXXXXXXXXXXXXXXXXXX
XXXXXXXXXXXXXXXXXXXXXXX
XXXXXXXX      XXXXXXXXX
XXXXXXXX      XXXXXXXXX
XXXXXXXX      XXXXXXXXX
XXXXXXXX p    XX  XXXXX
XXXXXXXX     pXX  XXXXX
XXXXX     XD      XXXXX
XXXXX          X  XXXXX
XXX     XXXXXX XX XXXXX
XX  p          D XXXXXX
XX      XXXXXX XXXXXXXX
XX      XXXXXX XXXX  XX
XX     pXXX    p  D  XX
XX        X p    XX  XX
XX      p           XXX
XX              pX  XXX
XXX       p         XXX
XX         D     X  XXX
XX       XXXX    XXXXXX
XXXXXXXXXXXXXXXXXXXXXXX
XXXXXXXXXXXXXXXXXXXXXXX