XXXXXXXXXXXXXXXXXXXX
XXXXXXXXXXXXXXXXXXXX
XXXXXXXXXXXXXXXXXXXX
XX p  XXXXX   XXXXXX
XX    XXXXX   XXXXXX
XXX  XXXXXXp  XXXXXX
X    XXXXXX   XXXXXX
X            XXXXXXX
X            XXXXXXX
X       XX   XXX  XX
X            D    XX
X                 XX
X       XX   XXX  XX
X      XXX   XXX  XX
X            XXXXXXX
X          p   XXXXX
XX             XXXXX
XXXXXXXXXXXXXXXXXXXX
XXXXXXXXXXXXXXXXXXXX
XXXXXXXXXXXXXXXXXXXX