XXXXXXXXXXXXXXXXXXXXX
XXXXXXXXXXXXXXXXXXXXX
XXXXXXXXXXXXXXXXXXXXX
XXXXp     XXXXXXXXXXX
XXXX      XXXXXXXXXXX
XXXX      XXXXXXXXXXX
XXXX          XXXXXXX
XXXX      XXX XXXXXXX
XXXX  p   XXX XXXXXXX
XXX   X XXXXX XXXXXXX
X        XXXX XXXXXXX
X                XXXX
X   p     p p    XXXX
X     p    p    DXXXX
Xp  p  p XX      XXXX
X        XX      XXXX
X    p           XXXX
XX       p       p XX
XXX                XX
XXXXXXXXXXXXXXXXXXXXX
XXXXXXXXXXXXXXXXXXXXX