XXXXXXXX
XXXXXXXX
XX  XXXX
XX  XXXX
X     XX
X    pXX
XXXXXXXX
XXXXXXXX