XXXXXXXXXXXXXX
XXXXXXXXXXXXXX
  XXXXXXXXXXXX
XXXX XXXXXXXXX
XXXX  XXXXXXXX
XXXX   XXXXXXX
XXXX   XXXXXXX
XXXD X X XXXXX
XXX  X    XX  
XXXX XX   X   
XXX  XX   XXX 
XXX XXX   XXXp
XXX XX    XXX 
XXX XX X  XXXX