XXXXXXXXXXXXXXXXXXXXXXXX
XXXXXXXXXXXXXXXXXXXXXXXX
XXXXXXXXXXXXXXXXXXXXXXXX
XXXXXXXXXXXXXXXXXXXXXXXX
XXX  XXXXXXXXXXXXXXXXXXX
XXX   D   XXXXXXXXXXXXXX
XXX  XXXX XXXXXXXXXXXXXX
X      XX XXXXXXXXXXXXXX
X         XXXXXXXXXXXXXX
X           XXXXXXXXXXXX
X       p    XXXXXX  XXX
X                    XXX
X             D      XXX
X       X      XXXXX XXX
X  p         X XXXX   XX
X            X XXXX   XX
X                     XX
X       D             XX
X                XX   XX
X   p            XXXXXXX
X        p       XXXXXXX
X                XXXXXXX
XXXXXXXXXXXXXXXXXXXXXXXX
XXXXXXXXXXXXXXXXXXXXXXXX