XXXXXXXXXXXX
X   XXXXXXXX
X   XXXXXXXX
X  XXXXXXXXX
X   XXXXXXXX
X   XXXXXXXX
X   XXXXXXXX
X       XXXX
XX      XXXX
XXXX    XXXX
XXXXXXXXXXXX
XXXXXXXXXXXX