XXXXXXXXXXXXXX
XXXXXXXXXXXXXX
XXXXXXXXXXXXXX
XXXXXX  XXXXXX
X  X    XXXXXX
X       X   XX
X           XX
XX   XX  XXXXX
XX       XXXXX
XXXXXXX  XXXXX
XXXXXXXXXXXXXX
XXXXXXXXXXXXXX
XXXXXXXXXXXXXX
XXXXXXXXXXXXXX