X XXXXXXXXXXXXXXX
XXX      XX XX  X
XXXX XXX XXXXX XX
XXXX  XX XXXX  XX
XXX      XXXX XXX
XXXX    XXXX  XXX
XXXX    XXX  pXXX
XXXXX   XXXXX XXX
X  XX   XXXXX    
XX XX   XXXXX   X
XXDXXX XXXXX    X
XX X  pXXXXX    X
XX X XXXXXXX   XX
XX    XXXXXXX  XX
XXXX  XXXXXXXXXXX
XXXX XXXXXXXXXXXX
XXXXXXXXXXXXXXXXX