XXX XXXXXXXXXXXXXXXXXX
XXX  XXXXXXXXXXXXXXXXX
XXXX  XXXXXXXXXXXXXXX 
XXXX   XXXXXX  XXXXXX 
X X   XXXXX   XXXXXXX 
X   XXXXXXX   XXXXXXXX
X    XXXXX  X XXXXXXXX
X XX   XXX  X  XXXXXXX
X  X  XXXX   X  XXXXXX
X XX  XXXX   XX p XXXX
X    XXXXX  XXXXX   XX
X   XXXXXX   XXXXX  XX
X   XXXX     XXXXX  XX
XX   XXXX X  XXXX   XX
XX   X    XX  XX  XXXX
Xp                p XX
XX XXX XXXXXX     XXXX
XX XX  XXXXXX     XXXX
XX  X  XXXXXXX       X
XXX   XXXXXXXXX   XX  
X  p XXXXXXXXXX    XX 
XX  DXXXXXXXXX     XXp