XXXXXXXXXXXXXXXXX
XXXXXXXXXXXXXXXXX
XXXXXXXXXXXXXXXXX
XXXXXXXXXXX   XXX
XXXX      D   XXX
XXXX XXXXXXX XXXX
XXX   XXXXXX XXXX
XXX   XXXXXX XXXX
XXX   XXXXXX XXXX
XXX   D     XXXXX
X      XXXXXXXXXX
X             XXX
X             XXX
X    XXXXXXXXXXXX
XXXXXXXXXXXXXXXXX
XXXXXXXXXXXXXXXXX
XXXXXXXXXXXXXXXXX