XXXXXXXXXXX
XXXXXXXXXXX
XXXXXXXXXXX
XX  XXXXXXX
XX    D XXX
X    XXDXXX
X    X  XXX
X  pXX  XXX
XXXXXXXXXXX
XXXXXXXXXXX
XXXXXXXXXXX