XX XXXXXXXX
XX    X XXX
XXXXX   XXX
XXXXX X  X 
XXXX  p    
XX   XX   D
XXXXXXXX   
XXXXXXXXX  
XXXXXXXXXXX
XXX   X X  
X   X      