XXXXXXXX
X XXXX X
X XXXXXX
   XXXXX
XXXXXXXX
  XXXXXX
XXXXXXXX
XXXXXXXX