XXXXXXXXXXXXXXXX
XX   XXXXXXXXXXX
XX   XXXXXXXXXXX
XXX XXXXXXXXXXXX
XXX XX   XXXXXXX
X        XXXXXXX
X    XX XXXXXXXX
XXX XXX XXXXXXXX
XXX XXX XXXX  XX
X    XX    X  XX
X  p          XX
X          X  XX
X          XXXXX
X     XXXXXXXXXX
XXXXXXXXXXXXXXXX
XXXXXXXXXXXXXXXX