XXXXXXXXXXXXXXXXXX
XXXXXXXXXXXXXXXXXX
XXXXXXXXXXXXXXXXXX
XX     X    XXXXXX
XX     X    XXXXXX
XX       X XXXXXXX
XX     X X      XX
XX   D          XX
XX   X          XX
XX   X     XX  XXX
XX         XX   XX
XX       XXXX   XX
XXX      XXXX   XX
XXX        XX   XX
XXX p      XX   XX
XXXXXX     XXXXXXX
XXXXXXXXXXXXXXXXXX
XXXXXXXXXXXXXXXXXX