XXXXXXXXXXXXX
XXX   XXXXXXX
XXX   XXXXXXX
XXX  XXXXXXXX
XXX    XXXXXX
XXX    XXXXXX
XXX  p XXXXXX
XX  X XXXXXXX
XX   XXXX  XX
XX   D     XX
XX   XXXXXXXX
XXXXXXXXXXXXX
XXXXXXXXXXXXX