XXXXXXXXXXXXXXXXXX
XXXXX XXXXXXXXXXXX
XXX   XXXXXXXXXXXX
XXXXXXXXXXXXXXXXXX
XXXXXXXXXXXXXXXXX 
XXXXXXXXXXXXXXX D 
XXXXXXXXXXXXXXXXXX
XXXXXXXXXX     D  
XXXXXXXXXXX   X  X
XXXXXXX X   X p   
XXXXXXXpD         
XXXXXXXXXXX   XXX 
XXXXXXXXXXX X DXXX
XXXXXXXXXXXXXX XXX
XXXXXXXXXXXX X XX 
XXXXXXXXXXXX      
XXXXXXXXXXXXXX    
XXXXXXXXXXXXXXXXX 