XXXXXXXXXX
XXX  XXXXX
XXX  XXXXX
X  X XXXXX
X     XXXX
XXX   XXXX
XXXX  XXXX
XXXX  XXXX
XXXXXXXXXX
XXXXXXXXXX