XXXXXXXXXXX
XX  XXXXXXX
XX  XXXXXXX
XX  XXXXXXX
XX  XXXXXXX
X   XXXXXXX
X      XXXX
XXp    XXXX
XX     XXXX
XXXXXXXXXXX
XXXXXXXXXXX