XXXXXXXXXX
X  XXXXXXX
X  XXX  XX
X       XX
Xp XXXX XX
X   XXX XX
XX    X XX
XX     XXX
XXXXXXXXXX
XXXXXXXXXX