XXXXXXXXXXXXXXXXX
XX  XD XX    XXXX
XX    XX       XX
XpD   XX XX    XX
XXX   XXXXX   XXX
XX    XXXXX  XXXX
XX    XXXX   XXXX
XX     XXX X XXXX
X      XXX X  XXX
XX  XXXXXDD    XX
X p XXXXX XXXX XX
XD XXXXXXXXXXX XX
X XXXXXXXXXXXX XX
XXXXXXXXXXXXXX   
XXXXXXXXXXXXXXXX 
XXXXXXXXXXXXXXXXX
XXXXXXXXXXXXXXXXX