XXXXXXXX  XX
XXXXXXXXX  X
XXXXXXXXXX  
XXXXXXXXXX  
X  XXXXXXXXp
XX   XXXXXXX
XXXX  XXXXXX
XXXX  XXXXXX
 XXXXXXXXXXX
XXXXXXXXXXXX
XXXXXXXXXXXX
XXXXXXXXXXXX