XXXXXXXXXXXXXXXXXXXXXX
XX     XXXXXXXXXXXXXXX
XX     XXXXXXXXXXXXXXX
XX     XXXXXXXXXXXXXXX
XXXX  XXXXXXXXXXXXXXXX
XXXX  XXXXXXXXXXXXXXXX
XXXX  XXXXXXXXXXXXXXXX
XXXX    XXXXXXXXXXXXXX
XXXX   pXXXXXXXXXXXXXX
XXXX       XXXXXXXXXXX
XXXX       XXXXXXXXXXX
XXXX       XXXXXXXXXXX
XXXX       XXXXXXXXXXX
XXXX       XXXXXXXXXXX
XXX       XX      XXXX
XXX               XXXX
XXX               XXXX
XXXX    p X       XXXX
XXX              XXXXX
XXX           DXXXXXXX
XXXXXXXXXXXXXXXXXXXXXX
XXXXXXXXXXXXXXXXXXXXXX