XXXXXXXXXXXXX
XXXXXXXXXXXX 
XXXXXXXXXXXXX
XXXXXXXXXXXXX
XXXXXXXXX XXX
XXXXXXXX    X
XXXXXXXXXX   
XXXXXXX XX  X
XXX  XX    XX
XXXX   DXXXXX
 XX    XX    
  D X     XXX
X  XX     XXX