XXXXXXXXXXXXXXXXXX
XXXXXXXXXXXXXXXXXX
XXX  XXXXXXXXXXXXX
XXX  XXXXXXXXXXXXX
XXXX XXX   XXXXXXX
XXXX XXXp  XXXXXXX
XX         X   XXX
XX     X   X   XXX
XX             XXX
XX  p          XXX
X      XXp  X  XXX
X           X  XXX
X        D     XXX
X      pXXXXX  XXX
X            XXXXX
X   XXXXXXXXXXXXXX
XXXXXXXXXXXXXXXXXX
XXXXXXXXXXXXXXXXXX