XXXXXXXXXXXXXXXXXXXX
X  Xp  XXXXXXXXXXXXX
X  X         XXXXXXX
X  D   XX     XXXXXX
X  XX   X   p XXXXXX
XX XX   X     XXXXXX
XX XX p       XXXXXX
XX XX   X X     XXXX
XX XX  XX X     XXXX
XX X       p    XXXX
X       X X     XXXX
X       X X   XXXXXX
X             XXXXXX
X            XXXXXXX
X        D   XXXXXXX
XX       XX   XXXXXX
XX            XXXXXX
XXXX    XXX   XXXXXX
XXXXXXXXXXXXXXXXXXXX
XXXXXXXXXXXXXXXXXXXX