XXXXXXXXXXXXXXXXXXXXXXXX
X   X   XX  XX    XXXXX 
X   X  XX  p            
XX                      
XX XX XXX      XX XXXXX 
XX  X XXXpDX    X XXXXX 
XXX X XXX   XXX X XXXXXX
XXX    X    XX    XXXXXX
XXXXX D    XXXX   DXXXXX
XXXXX      XXXXXXX  XXXX
XXXXXXX    XXXXXXX  XXXX
XXXXXX    XXXXXXXX XXXXX
XXXXXXD    XXXXXX  XXXXX
XXX     XX  XXXX  XXXXXX
XX   X  XXXXXXXX  DXXXXX
XXX     XXXXXXXX   XXXXX
XX  X  XXXXXXXXX  XXXXXX
XX  X  XXXXXXXXXX XXXXXX
XX XX  XXXXXXXXX  XXXXXX
XX XX  XXXXXXXXX  XXXXXX
XXXX  XXXXXXXXX   XXXXXX
XXXXXXXXXXXXXXXX XXXXXXX
XXXXXXXXXXXXXXXXXXXXXXXX
XXXXXXXXXXXXXXXXXXXXXXXX