XXXXX XXX
XXX  X   
XXXX X XX
XXXX XpX 
XXX pXXXX
XXX XXXXX
XXX XXXXX
X  DXXXXX
X  XXXXXX