XXXXXXXXXXXXXXXXXXXXX
XXXXXXXXXXXXXX  XXXXX
XXXXXX          XXXXX
XX     XXXXXXX  XXXXX
XX     XXXXXXXXDXXXXX
XX     XXXXXXXX XXXXX
XX     XXXXXXXX XXXXX
XX XXX X   p XX XXXXX
XX     X        XXXXX
XX  p  X     X  XXXXX
XX   p XXX XXX  XXXXX
X    ppXXX XXX  XXXXX
X      p       XXXXXX
X         XXX   XXXXX
X       XXXXX   XXXXX
X      D        XXXXX
XXX   XXXXXXX   XXXXX
XXX   XXXXXXXXXXXXXXX
XXXXXXXXXXXXXXXXXXXXX
XXXXXXXXXXXXXXXXXXXXX
XXXXXXXXXXXXXXXXXXXXX