XXXXXXXXXXXXXXXXXX
XXXXXXXX   XXX   X
XXXXXXXXXX X   X X
XXXXXXXXXX    XX X
XXXXXXXXXX    X   
XXXXXXXXXX  X     
XXXXXXXXX  XXXXX  
XXXXXXXXX  XXX   X
XXXXXXXXXXXX   XXX
XXXXXX  XXX  XXXX 
XXXX        XX    
XXX  XXXXXXXX   X 
XXXXXXXXXXXXXX    
XX XXX     XX     
XX  X  X X     X  
XXX    XXXXXXXXXXX
XXXXX XXXXXXXXXXXX
XXXXXXXX  XXXXXXXX