XXXXXXXXXXX 
XXXXX X    X
XXXXX  XX  X
XXXXXX  XXX 
X XXXXX X   
X  XXXXXX XX
X  XXXXXXXXX
XX  XXXXXXXX
XXXXXXXXXXXX
XXXXXXXXXXXX
XXXXXXXXXXXX
XXXXXXXXXXXX