XXXXXXXXXXXXXXXXXXXX
XXXXXXXXXXXXXXXXXXXX
XXXXXXXXXXX  XXXXXXX
XXXXXD D     XXXXXXX
XXXXX XX  X  XXXXXXX
XXXXX XX   DDXXXXXXX
XX     X  X  XXXXXXX
XX     XXDX  XXXXXXX
XX     XX X  D    XX
XX     XX X  X    XX
XX     XX XX      XX
XXXX         X    XX
XXXX         XXXXXXX
XXXX         XXXXXXX
XXXX     X   XXXXXXX
XXXX     X   XXXXXXX
XXX      XXXXXXXXXXX
XXX     XXXXXXXXXXXX
XXXXXXXXXXXXXXXXXXXX
XXXXXXXXXXXXXXXXXXXX