XXXXXXXXXXXX
X  XXXXXXXXX
X       DXXX
XXDXXXX   XX
XX p      XX
Xp  XXXX XXX
X   XXX  pXX
X   XXX   XX
X  p XXXXXXX
X    XXXXXXX
XXXXXXXXXXXX
XXXXXXXXXXXX