XXXXXXX XXXXXXXXXXX
XX  X XXX      XXXX
XXX X  XXX  X   XXX
XXX    XXX  XXX XXX
XXXX XXXp D XXX XXX
XXXX XXX XX XXX XXX
XXXX XXX  X  XX XXX
XXXXXXXXX X  X  XXX
XXXXXXXX       XXXX
XXXXXXXX X  X XXXXX
XXXXXX   XX X  XXX 
XXXXXXXX X     XXX 
XXXXXXXX X     X   
XXXXXXX DXX       X
XXXXXXX  XX XXX X X
XXXXX   X   XXX  XX
XXXXXXXXX XXXXXX X 
XXXXXXXXX XXXX     
XXXXXXXXXXXXXXXX XX