XXXXXXXXXXXXXXXXXXXXX
XXXXp X     X XXXXX X
XXXX DXD  X     pXX X
XXX          X  XXXDX
XXXX   XX      XXXX X
XXXX X X    XXXXXXX  
XXXX X X    XXXXXXXXD
X XX XX     XXXXXXXX 
X XX X    XXXXXXXXX  
X      X  XXXXXXXXX X
X  X      XXXXXXXXX X
X XXX XX    XXXXXX  X
X   XXX     XXXXXX  X
X XXXX      XXXXXXXXX
X    X   X  XXXXXXXXX
XXXXXXX  X  XXXXXXXXX
XXXXXXXXXXX XXXXXXXXX
XXXXXXXXXXX XXXXXXXXX
XXXXXXXXXXX  XXXXXXXX
XXXXXXXXXX   XXXXXXXX
XXXXXXXXXX XXXXXXXXXX