XXXXXXXXXXXXXXXXX
XXXXXXXXXXXXXXXXX
XXX  XXXXXXXXXXXX
XXX  XXXXXXXXXXXX
XXX      XXXXXXXX
XXX  XX    XXXXXX
XXXX XX  p XXXXXX
XXXX XX    XXXXXX
X    XX p XXXXXXX
X       p XXXXXXX
X      XXXXXXXXXX
XXX    XXXX    XX
XX             XX
XX     XXXX    XX
XX  XXXXXXXXXXXXX
XXXXXXXXXXXXXXXXX
XXXXXXXXXXXXXXXXX