XXXXXXXXXXXXXXXXXXX
X    XXXXXXXXXXXXXX
X    XXXXXXXXXXXXXX
X    X   XXXXXXXXXX
X    X   XXXXXXXXXX
X        XXXXXXXXXX
XXX  X   XXXXXXXXXX
XXX  X   XXXXXXXXXX
XX   XX XXXXXXXXXXX
XX      XXXXXXXXXXX
XX      XX  XXXXXXX
XX               XX
XX          XX   XX
X     X X   XX   XX
X           XX   XX
XXXXX      XXX   XX
XXXXX      XXXXXXXX
XXXXXXXXXXXXXXXXXXX
XXXXXXXXXXXXXXXXXXX