XXXXXXXXXXXX
XXXX   XXXXX
X  X   XXXXX
X  X   XXXXX
XX  X XXXXXX
XX        XX
XX     D  XX
X      XXXXX
X      XXXXX
X   XXXXXXXX
XXXXXXXXXXXX
XXXXXXXXXXXX