XXXXXXXXXXXX
XXXXXXXXXXXX
XXXXXXXXXXXX
XXXXX  XXXXX
X      XXXXX
X         XX
X   X  X pXX
X p D     XX
X   pp X  XX
X      XXXXX
XXXXXXXXXXXX
XXXXXXXXXXXX