XXXXXXXXXXXXXXXX
XXXXXXXXXXXXXXXX
XXX  XXXX   XXXX
XXX         XXXX
XXXX XX X   XXXX
XX   XX XXXXXXXX
XX   XX XXXXXXXX
XX            XX
XX   X  XXXX  XX
X    X        XX
X    XX XXXXXXXX
XXXX     XXXXXXX
XXXX     XXXXXXX
XXXXXXXXXXXXXXXX
XXXXXXXXXXXXXXXX
XXXXXXXXXXXXXXXX