XXXXXXXXXXXXXXXXXXX
XXXXXXXXXXXXXXXXXXX
XXXXXXXXXXXXXXXXXXX
XXXX     XXXX    XX
XXXX             XX
XXXX     XXXX    XX
XXXX     XXXX   XXX
XXXX     XXXX   XXX
XXXXXX XXXXXX   XXX
XXXXXX XXXXXX   XXX
XXXX   XXXXXX   XXX
XX           X XXXX
XX          pX XXXX
XX     p X    XXXXX
XX       Xp  XXXXXX
XX      XX   XXXXXX
XX      XXXXXXXXXXX
XXXXXXXXXXXXXXXXXXX
XXXXXXXXXXXXXXXXXXX