XXXXXXXXXXXXXXX
XXXXXX  XX   XX
XXXXXX pXX   XX
XXX          XX
XXX XX  XX   XX
XXX XX  XXX XXX
XX   X  X   XXX
XX   XXXX   XXX
XX   XXXX  XXXX
XX   XXXX  XXXX
XXXXXXXXXX   XX
XXXXXXXXXX   XX
XXXXXXXXXXX  XX
XXXXXXXXXXXXXXX
XXXXXXXXXXXXXXX