XXXXXXXXX
XXXXXXXXX
X  XXXXXX
X  XXXXXX
X   XXXXX
X p  XXXX
X p  XXXX
XXXXXXXXX
XXXXXXXXX