XXXXXXXXXXXXXXXX
X  XXXXXXXXXXXXX
X  XXX    XXXXXX
X         XXXXXX
X  XXX  p XXXXXX
XXXXXXXX XXXXXXX
X    XXX XX   XX
X             XX
X      D    XXXX
X       X   XXXX
X           XXXX
X    XXXX  XXXXX
X          XXXXX
XX   XXX   XXXXX
XXXXXXXXXXXXXXXX
XXXXXXXXXXXXXXXX