XXXXXXXXXXX
XXXXXX  XXX
X  XXX  XXX
X    XX XXX
XX   XX XXX
XX   XX XXX
X        XX
X   XXX  XX
XXXXXXX  XX
XXXXXXXXXXX
XXXXXXXXXXX