XXXXXXXXXXXXXXXXXXXXX
XXXXXXXXXXXXXXXXXXXXX
XXXXXXXXXXXXXXXXXXXXX
XXXXXXXXXXXXXXXXXXXXX
XXXXXXXXXXXXXXXXXXXXX
XXXXXXXXXXXXXXXXXXXXX
XXXXXXXXXXXXXXXXXXXXX
XXXXXXXXXXXXXXXXXX XX
XXXXXXXXXXXXXXXXX  XX
XXXXXXXXXXXXXXXX    X
XXXXXXXXXX XXXXXXX pp
XXXXXXXXXX   XXXXX X 
XXXXXXXXXX X XXXXX XX
XXXXXXXX   X       XX
XXXXXXXXXXDXXXX   XXX
XXXXXXXXX   X       X
XXXXXXXXX  XXD D XX  
X XXXXXXXX       XXXX
X XXXXXXX  D  X  XXXX
X  XXXXXX   D X  XXXX
X XXXXXXX     X  XXXX