XXXXXXXXXXX
XXXXXXXXXXX
XXXX  XXXXX
X  X     XX
X    XXX XX
XXD  XXX XX
XX    XX XX
XX    X  XX
XX       XX
XXXXXXXXXXX
XXXXXXXXXXX