XXXXXXXXXXXX
X  XXXXXXXXX
X  XXXXX  XX
X p   D   XX
X p XXXX  XX
XX   XXXX XX
X    D   XXX
X      XXXXX
X   p   XXXX
X       XXXX
XXXXXXXXXXXX
XXXXXXXXXXXX