XXXXXXXXXXXXXXXXXXX
X   XXXXXXXXXXXXXXX
X   XXXXXXXXXXXXXXX
X    X    XXXXXXXXX
X  p X    XXXXXXXXX
XXDX XXX XXXXXXXXXX
XX   XXX XXXXXXXXXX
XX       X  XXXXXXX
XX          XXXXXXX
XX       XXDXXXXXXX
XX      pXX XXXXXXX
XX        X X    XX
X         XDX    XX
X                XX
X         XXX p  XX
X     p   XXX    XX
XXX           DXXXX
XXXXXXXXXXXXXXXXXXX
XXXXXXXXXXXXXXXXXXX