XXXXX XXXX
XXXXXX    
XXXXXXX XX
   XXX  XX
XXXX   XXX
X XX XXXXX
XXXX XXXXX
XXXXpXXXXX
XXX  XXXXX
XXXD XXXXX