XXXXXXXXX
X  XXXXXX
X    XXXX
XX   XXXX
XX   XXXX
Xp   XXXX
X    XXXX
XXXXXXXXX
XXXXXXXXX