XXXXXXXXXXXXXXXXXXXXXXX
XXXXXX  XXXXXXXXXXXXXXX
XXX  X              XXX
XXX  X  XX     XXXX XXX
XXX  XXXXX      XXX XXX
XXX  XXXXX      XXX XXX
XXX  XXXXX  p   XXX XXX
XXX  XXXXXXX XX XXX XXX
XXXX XXXXXXX XX XXX XXX
XXXX XXXXXXX XX XXX XXX
XXXXDXXXXXXX XX XXX XXX
XXXX XXXXXXX XX XXX XXX
XXXX p   XXX XX XXp XXX
XXXX     XX         XXX
XXXX     X       X  XXX
XXXX p       XX XXXXXXX
XX           XX XXXXXXX
X        X   X  XXXXXXX
X   XX  XX   X  XXXXXXX
X  p   XXXX    XXXXXXXX
X   XX         XXXXXXXX
XXXXXXXXXXXXXXXXXXXXXXX
XXXXXXXXXXXXXXXXXXXXXXX