XXXXXXXDXX
XXXXXXXXXX
XXXXXXXXXX
XXXXXX  XX
XXXX      
XXXX XXX X
XXX  XXXX 
X   XXXXXX
X XXXXXX  
  XXXXX XX