XXXXXXXXXXXXXXXXXXX
XXXXXXXXXXXXXXXXXXX
XXXXXXXXXXXXXXXXXXX
XXXXXXXXXXXXXXXXXXX
XXXXXXXXXXXXXXXXXXX
XXXXXXXXXXXXXXXXXXX
X     XXXXXXXXXXXXX
X     XXXXXXXXXXXXX
X         X  XXXXXX
X            XXXXXX
XX  X     X  XXXXXX
XXXXX XXXXXX XXXXXX
XXX     XXXX     XX
XXX        X     XX
XXXX             XX
XXXXX      XX    XX
XXXXX          XXXX
XXXXXXXXXXXXXXXXXXX
XXXXXXXXXXXXXXXXXXX