XXXXX XXX
XXXXXXXX 
XX  XXXX 
XXXDXXXX 
XXX XXXXX
XXXpXXXXX
XXX   XXX
XXX   XXX
XXXXX  XX