XXXXXXXXXXXXXXXXXX
XXXXXXXXXXXXXXXXXX
XXXX     XXXXXXXXX
XXXX      D  XXXXX
XXXXXX XXXX   XXXX
XXXX          XXXX
XXXX X XXXX   XXXX
XXXX X   XXXXXXXXX
XX  p    XXXXXXXXX
XX       XXXXXXXXX
XXX XX   XXXXXXXXX
X    XD   XXXXXXXX
X     X   XXXXXXXX
X         XXXXXXXX
X    XX   XXXXXXXX
X    XXXXXXXXXXXXX
XXXXXXXXXXXXXXXXXX
XXXXXXXXXXXXXXXXXX