XXXXXXXXXXXXXXXXXXXX
XXXXXXXXXXXXXXXXXXXX
XXX   XXXXXXXXXXXXXX
XXX    XXXXXXXXXXXXX
XXXX X XXXXXXXX   XX
XXXX              XX
X        XX   XX XXX
X   p   XXX     XXXX
X               XXXX
X       XXXX XXDXXXX
XXX  D  XXXX XX XXXX
X        XXX XX XXXX
X              p  XX
XXX       pp      XX
XX                XX
XX          X     XX
XXX         XXXXXXXX
XXXXXX   p  XXXXXXXX
XXXXXXXXXXXXXXXXXXXX
XXXXXXXXXXXXXXXXXXXX