XXXXXXXXXXXXX X
X    XXXX   XXX
XD  XXXXXX  XX 
X    XXXXXXX p 
X XX XXXXXXXXpX
X DX XXXXXX   X
XX X  XXXXX  XX
XX XX XXXXX  XX
X     XXXXX XXX
X     XXXXX XXX
   X  XXXX  XXX
X XX  XXXX DXXX
X XX  XXXXX XXX
X XXXXXXXXX  XX
XXXXXXXXXXXXXXX