    XXXX
XXX XXXX
XXXDXXXX
XX  XXXX
XX  XXXX
XXXXXXXX
XXXXXXXX
XXXXXXXX