XXXXXXXXXXXXXXXXXXXXXXX
XXXXXXXXXXXXXXXXXXXXXXX
XXXXXXXXXXXXXXXXXXXXXXX
XXXXXXXXXXXXXXXXXXXXXXX
XXXXXXXXXXXXXXXXXXXXXXX
XXXXX  XXXXXXXXXXXXXXXX
XXXXX  DXXXXXXXXXXXXXXX
XXXXXXX XXXXXXXXXXXXXXX
X       XXXXXXXXXXXXXXX
X    p  XXXXXXXXXXXXXXX
X       XXXXXXXXXXXXXXX
X            X      XXX
X            X      XXX
X      DXX XXX      XXX
XX X XX XX XXX      XXX
XX X    XX XXX      XXX
X  X    XX XXXXXX XXXXX
X p                XXXX
X       XXXXXXXXX  XXXX
XXD     D           XXX
XX                  XXX
XXXXXXXXXXXXXXXXXXXXXXX
XXXXXXXXXXXXXXXXXXXXXXX