XXXXXXXXXXX
XXXXXXXXXXX
XXXXXXXXXXX
XXX  XXXXXX
XXXp    XXX
XXXX X  XXX
XXXX XXXXXX
X  X  XXXXX
X     XXXXX
XXXXXXXXXXX
XXXXXXXXXXX