XXXXXXXXXXXXXXXXXXXXX
XXXXXXXXXXXXXXXXXp XX
XXXXXXXXX          XX
XXXXXXXXX XXXXXXX  XX
XXXXXXXXX XXXXXXXX XX
X   XXXXX XXXXXXXX XX
X  p  XXX XXXX  XX XX
X        p      XX XX
X   XX      XX  XX XX
X   XX         XXX XX
X           XXXXXX XX
X         X XXXXXX XX
X                 XXX
X                  XX
XX           pXXX  XX
XXX                XX
XXXXXXXXX  XXXXXX  XX
XXXXXXXXp  XXXXXXXXXX
XXXXXXXX   XXXXXXXXXX
XXXXXXXXXXXXXXXXXXXXX
XXXXXXXXXXXXXXXXXXXXX