XXXXXXXXXXXXXXXXXX
XXXXXXX    X  XX D
X X              X
X      X  D  ppD X
XXXXDXXXX     XX X
XXX  XXXXXX X XX  
 XXXXXXXXXXXXXXXX 
XXXXXXXXXXXXXXXXXX
XXXXXXXXXXXXXXXXXX
XXXXXXXXXXXXXX    
XXXXXXXXXXX       
XXXXXXXXXXX XX    
XXXXX pXX     D   
XXXXX        X  XX
XXXX  XX  X  XXXXX
XXXX    pXX  XXXXX
XXXXXXXXXXX   XXX 
XXXXXXXXXXXXX     