XXXXXXXXXXXXXXXXXXXXXXXX
XXXXXXXXXXXX   XXXXXXXXX
XXXXXX         XXXXXXXXX
XXXXXXDXXXXXX XXXXXXXXXX
XXXXXX XXXXXX XXXXXXXXXX
XXXXXX XXXXXX XXXXXXXXXX
XXXX     XXXX XXXXXXXXXX
XXXX     XXXX XXXXXXXXXX
XXX    XXXXXX XXXXXXXXXX
XXX     XXXXX XXXXXXXXXX
XXX      XXXX XXXXXXXXXX
XXX        XX XXXXX   XX
XXX            XXXX   XX
X                     XX
X          XX  XXXX   XX
X          XX  XXXX   XX
X           XD XXXXX XXX
X                XXX XXX
X   D            XXX XXX
XXXXX               XXXX
XXXXXX           XXXXXXX
XXXXXXXX         XXXXXXX
XXXXXXXXXXXXXXXXXXXXXXXX
XXXXXXXXXXXXXXXXXXXXXXXX