XXXXXXXXXXXXX
XXXXXXXXXXXXX
XXXXXXXXXXXXX
X   XXXXXXXXX
X   XXXXX  XX
X     XXX  XX
XX     XXX XX
XX        XXX
XX      p XXX
XX        XXX
XX  XXX   XXX
XXXXXXXXXXXXX
XXXXXXXXXXXXX