XXXXXXXXXXXXXXXXXXX
XXXXXXXXXXXX   X  X
XXXXXXXXX    X    X
XXXXXXXX pXXXX     
XXXXXXXXXXXXXX     
XXXXXXXXXXXXX  XX  
XXXXXXXXXXX    XX p
XXXXXX XXXX XXXXX  
X XXX       XXXX   
X   X XX   XXX     
XXX   XXXX     X  X
XXXXXXXXXXXXXXXXX  
XXXXXXXXXXXXXXXXX X
XXXXXXXXXXXXXXXXXXX
XXXXXXXXXXXXXXXXXXX
XXXXXXX XXXX  XXX  
X       XX        X
X XXX X X         X
XXXXXXX    p X   Dp