XXXXXXXXXXXXXXXXXX
XXXXXXXXX    XXXXX
XXXXXXXXX    XXXXX
Xp           XXXXX
X  XXXXXX    XXXXX
X  XXXXXXXX XXXXXX
X  XXXXXXXX XXXXXX
X  XXXXXX      XXX
XXXXX          XXX
XXXX  XXX      XXX
XXXX         p XXX
XXXX  XXXX X   XXX
XXXXXXXXXX XXXXXXX
XXXXXXXXXX  XXXXXX
XXXXXXXXXX  XXXXXX
XXXXXXXXXX  XXXXXX
XXXXXXXXXXXXXXXXXX
XXXXXXXXXXXXXXXXXX