XXXXXX XXXXXXXXXX
XXXXXXXXX XXXXXXX
XXXXXXXXX XXXXXXX
XXXXXXXXX    XXXX
XXXXXXXXXXXX XXXX
XXX XXXXX     XXX
XXX  XXXX XXXXXXX
X   XXXXX XXXXX X
X   XXXXX X XX  X
X    XXX    XX XX
XX XXXXXXX  X  XX
X  XXXXXXXX X XXX
X XXXXXXXXX  p   
XXXXXXXXXX     X 
XXXXXXXXX    XXX 
XXXXXXXXX    XXX 
X XXXXXX     XXX 