XXXXXXXXXXXX
Xp XXXXXXXXX
X   XXXXXXXX
X   XXXXXXXX
XX  XXX   XX
XX  p D   XX
X    XX   XX
X     Xp  XX
X     D   XX
XX    X   XX
XXXXXXXXXXXX
XXXXXXXXXXXX