XXXXXXXXXXXXXXXXXX
XXXXXXXXXXXXXXXXXX
XXXXXXXXXXXXXXXXXX
X    XXXXXXXXXXXXX
X          D   XXX
XXX XXXXXXXXXX XXX
XXX XXXXXXXXXX XXX
XXX    XXXXXXX XXX
XXX    XXXXXXX XXX
X      XXXXXXX XXX
X     XXXXXX    XX
X               XX
X     X    XXXXXXX
XXX        XXXXXXX
XXXXXXX    XXXXXXX
XXXXXXX p  XXXXXXX
XXXXXXXXXXXXXXXXXX
XXXXXXXXXXXXXXXXXX