XXXXXXXXXXXXXXXXXXXXXXX
XXXXXXXXXXXXXXXXXXXXXXX
XXXXXXXXXXXXXXXXXXXXXXX
XXXXXXXXXXXXXXXXXXXXXXX
XXXXXXXXXXXXXXXXXXXXXXX
X      XXXXXXXXXXX   XX
X        D    p XX   XX
XXXX XDXXX      XXX XXX
XXXX X XXX      D  XXXX
X        X      XXXXXXX
X        X XX XXXXXXXXX
X           X XXXXXXXXX
X             XXXXXXXXX
X                  XXXX
XXX    X   XX XXXX XXXX
XXX           XXXX XXXX
XX  p         XX    XXX
XX                  XXX
XX           XXX    XXX
XXXX         XXXXXXXXXX
XXXX         XXXXXXXXXX
XXXXXXXXXXXXXXXXXXXXXXX
XXXXXXXXXXXXXXXXXXXXXXX