XXXXXXXXX
XXX XX pX
XXX X DXX
XXX  p XX
XXX pXXXX
XXX  XXXX
X   XXXXX
XDXXXXXXX
X XXXXXXX