XXXXXXXXXXXXX
X   XXXXXXXXX
X      XXXXXX
XX     XXXXXX
X   X  XXXXXX
X         XXX
X   X  X pXXX
X      X  XXX
X    ppX  XXX
X      XXXXXX
X  X   XXXXXX
XXXXXXXXXXXXX
XXXXXXXXXXXXX