XXXXXXXXXXXXXXXXXXX
XXXXXXXXXXXXXXXXXXX
X  XXXXXXXXXXXXXXXX
X    D       XXXXXX
XX XXXXXXX     XXXX
XX       D     XXXX
XX  XXXXXXXX XXXXXX
XX  XXXXXX    XXXXX
XX  XXXXXX    XXXXX
XX  XXXXXX    XXXXX
XX  XXXXXX    XXXXX
XX  X    X    XXXXX
XX p     XXXXXXXXXX
XXXXXXXXXXXXXXXXXXX
XXXXXXXXXXXXXXXXXXX
XXXXXXXXXXXXXXXXXXX
XXXXXXXXXXXXXXXXXXX
XXXXXXXXXXXXXXXXXXX
XXXXXXXXXXXXXXXXXXX