XXXXXXXXXXXXX XXXXXXXXX
 XXXXXXXXX  XXXXXXXXXXX
XXXXXXXXXXX XXXXXXXXXXX
XXXXXXXXXXX XXXXXXXXXXX
XXXXXXXXXX  XXXXXXXXXXX
XXXXXXXXXX  XXXXXXXXXXX
XXXX  XXXXX XXXXXXXXXXX
XXXX   XXXX  XXXXXXXXXX
X XXXD XXXXX XXXXXXXXXX
X XXX  XXXXX XXXXXXXXXX
X XXXX XXXXX  XXXXXXXXX
X XXXX XX     XXXXXXXXX
X XX X XX XXXXXXXXXXXXX
X  X X  XD XXXX  XXXXXX
XX X X   X XXXX pX  XXX
XX     X   XXXXX  X XXX
XX   XXX    XXXXXDD XXX
X    XXX XX XXX p    XX
XXX  XXX XX XXXX X  XXX
XXX   XX    XXXX X  XXX
XXX X XX  XXXXX    XXXX
XX    XX   XXXX    XXXX
XX  XXXX  XXXXX  X  XXX