XXXXXXXXXXXXXXXXXXX
XXXXXXXXXXXXXXXXXXX
XXXXXXXXXXXXXXXXXXX
X  XXXXXXXXXXXXXXXX
X        XXXX   XXX
X  XXXXX XXXX   XXX
XX          D   XXX
XXp         X  pXXX
XX     X XX X   XXX
XX       XX X   XXX
X         D     XXX
X        XX X   XXX
X  pp   p   XX XXXX
X p  p      p  XXXX
X              XXXX
X      pp     XXXXX
XXXXX     XXXXXXXXX
XXXXXXXXXXXXXXXXXXX
XXXXXXXXXXXXXXXXXXX