XXXXXXXXXXXXXXXX
XXXXXXXXXXXXXXXX
X   XX   XXXXXXX
X   D    XXXXXXX
XXD  XX XXXXXXXX
Xp   XXDXXXXXXXX
X    XX XXXXXXXX
X  p XX XX   XXX
XX   XX XXp  XXX
XX        D  XXX
XX      p  p XXX
XX    X      XXX
XX     p XXXXXXX
XX   XXXXXXXXXXX
XXXXXXXXXXXXXXXX
XXXXXXXXXXXXXXXX