XXXXXXXXXXXXXXXXXXXXXX
XXXXXXXXXXXXXXXXXXXXXX
XXXXXXXXXXXXXXXXXXXXXX
XXXXXXXXXXXXXXXXXXXXXX
XXXXX  XXXXXXXXXXXXXXX
XXXXX        D   XXXXX
XXXXX  XXXXXXXXX XXXXX
XXXXXX XXXXXXXXX XXXXX
XXXXXXDXXXXXXX    XXXX
XXXXXX XXXXXXX p  XXXX
XXX     XXXXXX    XXXX
XX p       XXX    XXXX
XX          XXXXXXXXXX
XX          XXXXXXXXXX
XX          XXXXXXXXXX
XX          XXXXXXXXXX
XX               XXXXX
XXX     p        XXXXX
XXX  p       XX  XXXXX
XXX    p     XXXXXXXXX
XXXXXXXXXXXXXXXXXXXXXX
XXXXXXXXXXXXXXXXXXXXXX