XXXXXXXXXXXXXXXXXXX
XXXXXXXXXXXXXXXXXXX
XXXXXXXXXXXXXXXXXXX
XXXXXXXXXXXXXXXXXXX
XXXXXXXXXXXXXXX  XX
XXXXXXXXXD       XX
XXXX  XXX X  XXX XX
X p   XXX X  XXXDXX
X     XXX XX XXX XX
X     D         XXX
X     XXX     XXXXX
XX            XXXXX
XX    XXX XXXXXXXXX
XX    XXX XXXXXXXXX
XXXXX XX   XXXXXXXX
XXXXX  D   XXXXXXXX
XXXXXXXX   XXXXXXXX
XXXXXXXXXXXXXXXXXXX
XXXXXXXXXXXXXXXXXXX