XXXXXXXXXXXXXXXXX
XXXXXXXXXXXXXXXXX
XXXXXXXXXXXXXXXXX
XXXXXXX   XXXXXXX
XXXXXXX   XXXXXXX
XXXXXXX   XX  XXX
XXXXXXXX XXX  XXX
XXXXXXXX XXXX XXX
XXXXXXXX XX   XXX
XXXXXXXX      XXX
XXXXX  X XXX  XXX
XXXXX       X XXX
XXXXXXXX XXXX XXX
XXXXXX    XXX XXX
XXXXXX       XXXX
XXXXXXXXXXXXXXXXX
XXXXXXXXXXXXXXXXX