XXXXXXXXXXXXXXXXXXX
XXXXXXXXXXXXXXXXXXX
XXXXXXXXXXXXXXXXXXX
XXXXX  XXXXXXXXXX  
XXXXXX XXXXXXXXXX  
XXXXXX   XXXXXXXX  
XXXXXXXX XXX  D  D 
XXXXXXX  X        X
XXXXXXX   p  XXX   
XXXXXXXXXXXX       
XXXXXXXXXXXX X   X 
XXXXXXXXXXXXXX     
XXXXXXX    XXX XX  
XXXXXXX XX XX  XX X
XXXXXXXXXX XX XX XX
XXX    XXX       XX
XXXXXX XX          
XXXXXX D  X XXXX  X
XXXXXXXD XXXXXX  XX