XXXXXXXXXX
X  XXXXXXX
X   XXXXXX
XX  XXXXXX
X    XXXXX
X p    DXX
X   XX  XX
XX  XX  XX
XXXXXXXXXX
XXXXXXXXXX