XXXXXXXXXXXXXXX
XXXXX      XX X
XXXXX     XXXXX
XXXXXX  pXXXXXX
XXXXX    XXXXXX
XXXXX    XXXXXX
XXXXXXX  XXXXXX
XXXXXXX  XXXXXX
XXXXXXX  XXXXXX
XXXXXXXX   X  p
XXXXXXXX   X XX
XXXXXXXX   X XX
X XXXXXX X   XX
X XXXXXX    XXX
XXXXXXXXXX   XX