XXXXXXXXXXXX
XXX    XXXXX
XX  X XXXXXX
XD X   pXXXX
 X XXXX  XXX
X XXXXX    X
X  XXXXX XXX
XX    XX XXX
 XXX    DXXX
XXXX  XXXXXX
XXX   XXXXXX
XXXX XXXXXXX