XXXXXXXXXXXX
XXXXXXXXXXXX
XXXXXXXXXXXX
XX pXXXXXXXX
XX  XXXXXXXX
XX  XXXXXXXX
X     X  XXX
Xp    D  XXX
X     X  XXX
X    p  XXXX
XXXXXXXXXXXX
XXXXXXXXXXXX