XXXXXXXXXXXXXXXXXXX
XX    XXXXXXXXXXXXX
XX    XXXXXXXXXXXXX
XX    XXXXXXXXXXXXX
XXX XXXXXXXXXXXXXXX
XXX XXXXXXXXXXXXXXX
X      XXXXXXXXXXXX
X      XXXXXXXXXXXX
X      XXXXXXXXXXXX
X      XXXXXXXXXXXX
XXX X  XXXXXXXXXXXX
XXX        XXXXXXXX
X           XXXXXXX
X            XXXXXX
X       p    XXXXXX
X  p     XXXXXXXXXX
X        XXXXXXXXXX
XXXXXXXXXXXXXXXXXXX
XXXXXXXXXXXXXXXXXXX