XXXXXXXXXXXXXXX
XXXXXXXXXXXXXXX
XX    XXXXXXXXX
XX     D   XXXX
XXXX XXXXX XXXX
XXX    XXX XXXX
XXXp   XXX XXXX
XX     XXX XXXX
XX     XXX XXXX
XX     XX  XXXX
XX         XXXX
XX      X  XXXX
XX    p XXXXXXX
XXXXXXXXXXXXXXX
XXXXXXXXXXXXXXX