XXXXXXXXXXXX
XXXXXXXXXXXX
XXXXXXXXXXXX
XXX  XXXXXXX
XXX  XXXXXXX
X  X XX  XXX
X        XXX
X        XXX
X    X   XXX
X    X   XXX
XXXXXXXXXXXX
XXXXXXXXXXXX