XXXXXXXXXXXXXXXXXXX
XXXXX    XXXXXXXXXX
XX  X    XXXXXXXXXX
XX       XXXXXXXXXX
XXX X    pXXXXXXXXX
XXXDX     XX   XXXX
X              XXXX
X     X XXXX   XXXX
X        XXXX XXXXX
X        XXXX XXXXX
Xp            XXXXX
X     p       XXXXX
X             XXXXX
X    D        XXXXX
XXp           XXXXX
XX  XX     XXXXXXXX
XXXXXX  XXXXXXXXXXX
XXXXXXXXXXXXXXXXXXX
XXXXXXXXXXXXXXXXXXX