XXXXXXXXXXXXXXXXXXXXX
XXXXXXXXXXXXXXXXXXXXX
XXXXXXXXXXXXXXXXXXXXX
XXXXXXXXXXXXXXXXXXXXX
XXXXXXXXXXXXXXXXXXXXX
X      XXXXXXXXXXXXXX
X  p   XXXXXXXXXXXXXX
XX  D  DXXXXXXXXXXXXX
XX        XXXXXXXXXXX
XX        XXXXXXXXXXX
X    X      XXXXXXXXX
X    X      XXXXXXXXX
X         XXXXXXXXXXX
X    p      X      XX
X        p  X      XX
X                  XX
XX                 XX
XX    XX     XXXXXXXX
XXXXXXXX     XXXXXXXX
XXXXXXXXXXXXXXXXXXXXX
XXXXXXXXXXXXXXXXXXXXX