XXXXXXXXXXXXXXXXXXXXXX
XXXXXXXXXXXXXXXXXXXXXX
X      XXXXXXXXXXXXXXX
X      XXXXXXXXXXXXXXX
X      XXXXXXXXXXXXXXX
X      XXXXXXXXXXXXXXX
XXX  XXXXXXXXXXXXXXXXX
XXX     XXXXXXXXXXXXXX
XXX     XXXXXXXXXXXXXX
XXX               XXXX
XXX               XXXX
XXX     XXXXXXXXX XXXX
XXX      X  XXX    XXX
X      p           XXX
X           XXXXX XXXX
X           X  XX XXXX
XXX X       X  X  XXXX
XXX            X  XXXX
XXXXX             XXXX
XXXXXXXXXXXXXXXX  XXXX
XXXXXXXXXXXXXXXXXXXXXX
XXXXXXXXXXXXXXXXXXXXXX