XXXXXXXXXXXXXXXXX
XXXXXXXXXXXXXXXXX
XXXX    XXXXXXXXX
XX      XXXXXXXXX
X   pX XXXXXXXXXX
X       XXXXXXXXX
XXXD    XXXXXXXXX
X              XX
X   p          XX
XXX     XXX    XX
XXXX    XXX X XXX
Xp       XX X XXX
X     p  XX X XXX
X        X    XXX
X       XX   XXXX
XXXXXXXXXXXXXXXXX
XXXXXXXXXXXXXXXXX