XXXXXXXXXXXXX
XXXXXXXXXXXXX
XXXXXXXXXXXXX
XXXXXXXXXXXXX
XXXXXXXXXXXXX
XXXXX   XXXXX
XXXXX    XXXX
XXXXXX X XXXX
XXXX      XXX
XXXX      XXX
XXXX p XXXXXX
XXXXXXXXXXXXX
XXXXXXXXXXXXX