XXXXXXXXXXX
  XXXXXXXXX
X XXXXXX  X
X XXXXX  XX
 XXXX   XXX
XXXXXX  XXX
XXXXX X XXX
XXXXX    XX
XXXXXDXX XX
XXXXX XD XX
XXXX  XDXXX