XXXXX XXXX
XXXXX   XX
XXXXXX  XX
XXXXXX XXX
XXXXX  XXX
XXXXX XXXX
XXXXX   XX
XXXXXXX   
XXXXXXX  X
XXXXXXXX X