XXXXXXXXXXXXXXXX
XXXXXX  XXXX  XX
X    X        XX
X    X   XXXX XX
X    X  DXXXX XX
XX  XXX  XXXX XX
X   XXX  XX   XX
X    XXD XX   XX
X             XX
X    D        XX
X   XX   pX   XX
X             XX
X      XXXXXXXXX
X  XXXXXXXXXXXXX
XXXXXXXXXXXXXXXX
XXXXXXXXXXXXXXXX