XXXXXXXXX
Xp XXXXXX
X  XX  XX
X  XX  XX
X  XXXDXX
X     XXX
X   p XXX
XXXXXXXXX
XXXXXXXXX