XXXXXXXXXXXXXXXXX
XX   XXXXXXXX   X
XXXXXXXXX  X     
   XXXXXX    XXXX
X  XXXXXX  XXXXXX
X    XXX      X  
XXXX   X  XXX X  
XXXXXX X XXXX   X
XXXXXXD  XXXXXXXX
XXXXXXXXXXXXXXXX 
XXXXXXXXXXXXXXXXX
XXXXXXXXXXXXXX XX
XXXXXXXX DXXXX   
XXXXXXXX  DXXXXXX
XXXXXXXXXX  XXXXX
XXXXXXXXX   XXXXX
XXXXXXXXXX   XXXX