XXXXXXXXXXXXXXXXX
XXXXXXXXXXXXXXXXX
XXXXX  pXXXXXXXXX
XXXXX   XXX    XX
XXXXX          XX
XXXXXX    X    XX
XX  XX    XXX XXX
XX  XX       XXXX
XX        XXXXXXX
XX  X  X XXXXXXXX
XXX    X XXXXXXXX
XXX     XXXXXXXXX
XXX     XXXXXXXXX
XXX     XXXXXXXXX
XXXX  p XXXXXXXXX
XXXXXXXXXXXXXXXXX
XXXXXXXXXXXXXXXXX