XXXXXXXXXXXXXXXXXX
XXXX  XXXXXXXp XXX
XXXX      XXX  XXX
XX D         p XXX
XX XX XXXDXXX  XXX
X     XXX XXXX XXX
X         XXXX XXX
X     Xp    XX XXX
X             XXXX
XX  D X  XXXXXXXXX
XX        XXXXXXXX
XX         X    XX
X          X   pXX
X          D    XX
XXX    XXXXX    XX
XXX    XXXXXXXXXXX
XXXXXXXXXXXXXXXXXX
XXXXXXXXXXXXXXXXXX