XXXXXXXXXXXXXXXXXXXX
XXXXXXXXXXXXXXXXXXXX
XXXXXXXXXXXXXXXXXXXX
XXXXXXXXXXXXXXXXXXXX
XXXXXXXXXXXXXXXXXXXX
XXXXXXXXXXXXXXXXXXXX
XXXXXXXXXXXXXXXXXXXX
XXXXX    XXXXXXXXXXX
XXXX        XXXXXXXX
XXXX       D    XXXX
XXXX     X  XXX XXXX
X      p    XXX XXXX
X      X X  XX  XXXX
X          XXX  XXXX
X     XX X XXX  XXXX
X      X     XXXXXXX
XXX   p      XXXXXXX
XXXX   X     XXXXXXX
XXXXXXXXXXXXXXXXXXXX
XXXXXXXXXXXXXXXXXXXX