XXXXXXXXXXXX
XXXXXX   XXX
X  p     XXX
X p XXXp XXX
X        XXX
X   XXX  XXX
X      X XXX
X      p XXX
X       XXXX
XXXXX   XXXX
XXXXXXXXXXXX
XXXXXXXXXXXX