XXXXXXXXXXXX
XX   XXXXXXX
XX   XXXXXXX
XXX XXXXXXXX
XX   XXXXXXX
XX   X   XXX
XX       XXX
X   X X XXXX
X      XXXXX
X  p   XXXXX
XXXXXXXXXXXX
XXXXXXXXXXXX