XXXXXXXXXXXXXXXXXXXXXXXX
XXXXXXXXX  XXXXXXXXXXXXX
XXXXXX  X  XXXXXXXXXXXXX
XXXXD   X  XXXXXXXXXXXXX
XXXX XX X       XXXXXXXX
XXXX XX X  XXXX XXXXXXXX
XXXX XX X  XXXX XXXXXXXX
X p     X  XXXX XX   pXX
X       XX XXXX XX    XX
XXXX         XX XX    XX
XX           XX XX    XX
XX          XXX XXXX XXX
XX          XXX XXXX  XX
XXXX        XXX XXXX  XX
XXXX        XXX XXXX  XX
XXXX                  XX
XXXX        X    XXX  XX
XX          X    XXX  XX
XX                    XX
XX                   XXX
XX     X     XXXXXXXXXXX
XX     XXXXXXXXXXXXXXXXX
XXXXXXXXXXXXXXXXXXXXXXXX
XXXXXXXXXXXXXXXXXXXXXXXX