XXXXXXXXXXXXXXXXXXXXX
XXXXXXXXXXXXXXXXXXXXX
XXXXXXXXXXXXXXXXXXXXX
XXXXX     XXXXXXXXXXX
XXXXX     XXXXXXXXXXX
XXXXXX  XXXXXX   XXXX
XXXXXX  XXXXXX   XXXX
XX               XXXX
XX X     XXXXX   XXXX
X        XXXXXX XXXXX
X         X   p  XXXX
X         X      XXXX
X         X      XXXX
X    p           XXXX
X   p            XXXX
X    XX XXXX    XXXXX
X    XX   p     XXXXX
XXX             XXXXX
XXX             XXXXX
XXXXXXXXXXXXXXXXXXXXX
XXXXXXXXXXXXXXXXXXXXX