XXXXXXXXXXXXXXXXXXXX
XXXXXXXXXXXX   XXXXX
XX p           XXXXX
XX       XXXX XXXXXX
XXX XXXX XXXX XXXXXX
XXX XXXX XXXX XXXXXX
XXX XXXX XXXX XXXXXX
XXX    X XXXX XXXXXX
XXX    X XXXXDXXXXXX
XXX       XXX XXXXXX
XXX    X  XXX XXXXXX
XX     X   XX XXXXXX
X      X        XXXX
X         XXX    XXX
X        pXXX    XXX
X    XXXXXXXX    XXX
XXXXXXXXXXXXX    XXX
XXXXXXXXXXXXX    XXX
XXXXXXXXXXXXXXXXXXXX
XXXXXXXXXXXXXXXXXXXX