XXXXXXXXXXXXXXXXXXXXXX
XXXXXXXXXXXXXXXXXXXXXX
XXXXXXXXXXXXXXXXXX   X
XX XXXXXXXXXXXXXXXX XX
XX XX  XXXXXXXXXXXX XX
XX D  XXXXXXXXXXXXX XX
XX   XXXXXXXXXX XXX XX
XX   XXXXXXXXXX  X  XX
XX   XXXXXXXXXXX X XXX
XX   X  XXXXXXXX X XXX
XX  p  XXXXXXXXX   XXX
X     XXXXXXXXXX    XX
XX    XXXXXXXXX     XX
X    DXXXXXXXXX    XXX
XX    XXXXXXXX   X XXX
X                  XX 
X X X XXXXX D XD XXXX 
X   p XXXXXDDX   XXXXX
X    XXXXXXX XX   XXXX
X  D  XXXXXX X    DXXX
X  pD  pXXXX XX X XXXX
XXXXXXX  XXX XX    XXX