XXXXXXXX
XXXXXXXX
XXX  XXX
XXX  XXX
XXXX  XX
XXXX  XX
XXXXXXXX
XXXXXXXX