XXXXXXXXXXXXXXXXXXXXX
XXXXXXXXXXXXXXXXXXXXX
X      XXXXXXXXXXXXXX
X      XXXXXXXXXXXXXX
X      XXXXXXXXXXXXXX
X      XXXXXXXXXXXXXX
XXXX X XXXXXXXXXXXXXX
XX   X XXXXXXXXXXXXXX
X    X       XXXXXXXX
X            XXXXXXXX
XX                XXX
XX             X   XX
X       XX     X   XX
X        X         XX
X             XX   XX
X       p     XX   XX
X             XXXXXXX
X   p         XXXXXXX
X   p  XX     XXXXXXX
XXXXXXXXXXXXXXXXXXXXX
XXXXXXXXXXXXXXXXXXXXX