XXXXXXXX XXX
X XXXX pD pX
X XXXXX   XX
X  XXXX   XX
XX XXXX   XX
XXXXXX  X  X
XXXXXX XX  X
XXXXXX Xp  X
XXXX     XXX
XXXXX XXXXXX
 XXXXXXXXXXX
XXXXXXXXXXXX