XXXXXXXXXXXX
XXXXXXXXXXXX
XXXXXXXXXXXX
X   XXXXXXXX
X      XXXXX
X    X XXXXX
X    X XXXXX
X    X XXXXX
X   X   XXXX
XX      XXXX
XXXXXXXXXXXX
XXXXXXXXXXXX