XXXXXXXXXXXXXXXXXXXXXXXX
X  XXXXXX  XXXXX     XXX
X XXXXXXXXXXX      D XXX
X  p   p                
Xp              p       
X XXX XXXXXX XXXXX    DX
  XXX XXXXX DXXX      XX
X  XX  XXXX XXXX      XX
XX XXX      XXXXX   X  X
XX XXXXXX    XXXXXX p  X
XX XXXXXX  XD XXXXXXX  X
XX XXXXXX XXX  XXXXXXX  
X     XXXpXXXX  XXXXXXX 
XXXXX XXX XXXXX XXXXXX  
XXXXX XXX XXXXXD XXXXX X
XXXXX XX DXXXXXX XXXXX X
XXXXX  X XXXXXXX XXXXX X
XXXXXX   XXXXXXX XXXXX X
X   XXX   XXXXX  XXXX  X
X   XXXXX  XXXX XXXXX XX
X  XXXXXX  XXX  XXXXX XX
XXXXXXXXX  XXX XXXX   XX
XXXXXXXXX  XX  XXXX XXXX
XXXXXXXX  XXXX XXXXXXXXX