XXXXXXXXXXXXXXXXXXXXX
XXXXp XXXXXXXXXXXXXXX
XXXX  D        XXXXXX
XXXX    XXXXXX XXXXXX
XXXX    XXXXXX XXXXXX
XXXX   XXXXXXX XXXXXX
XXXX   XXXXXXX XXXXXX
XXX    XXXXX     XXXX
XXX    XXXXX     XXXX
XXX    XXXXX     XXXX
XX               XXXX
XX     XXXXX     XXXX
XX      XXXX     XXXX
X                XXXX
X       XXXX     XXXX
X  p   p   X p   XXXX
X    X     XX   p  XX
X                  XX
XXXXXXXXXXXXX      XX
XXXXXXXXXXXXXXXXXXXXX
XXXXXXXXXXXXXXXXXXXXX