XXXXXXXXXXXXXXXXXXX
XX   XXXXXXXXXXXXXX
XX   XXXXXXXXXXXXXX
XX    XXXXXXXXXXXXX
XX    XXXXXXXXXXXXX
X  DX XXXXXXXXXXXXX
X     XXXXXXXXXXXXX
XX    XXXXXX p  XXX
XX      XXXX    XXX
X             XXXXX
X     p          XX
XX  p        X   XX
XX               XX
XX X  p XXXX X   XX
XX     pXX    XXXXX
XXXXXXD       XXXXX
XXXXXXXXXXXXXXXXXXX
XXXXXXXXXXXXXXXXXXX
XXXXXXXXXXXXXXXXXXX