XXXXXXXXXXXXXXX
XXXXXXXXXXXXXXX
XXXXXXXXXXXXXXX
XXXXXXXXXXXXXXX
XXXXXXXXXXX  XX
X   XXXXXXX  XX
X   X        XX
X   D     X  XX
X     XX  XX XX
XX p   D  XX XX
X       XXXX XX
X        DD XXX
X        XXXXXX
XXXXXXXXXXXXXXX
XXXXXXXXXXXXXXX