XXXXXXXXX
XXXXXXXXX
XX  XXXXX
XX  XXXXX
Xp    XXX
X   ppXXX
X  XXXXXX
XXXXXXXXX
XXXXXXXXX