XXXXXXXXXXXXXXX
X XXXXXXXXXXXXX
X XXXXXXXXXXXXX
 XXXXXXXXXXXXXX
XXX  pXXXXXXXXX
XXX   XXXXXXXXX
XXX X    XXXXXX
XX DXXXX XXXXXX
X  XXXXX XXXXXX
   XXXXX XXXXX 
XX XXXXX  XX   
   XXXXXX  X  X
X   XXXXX     X
XXX XXXXXX   XX
XX  XXXXXX   XX