XXXXXXXXXXXXXXXX
XXXXXXXXXXXXXXXX
XXXXXXXXXXXXXXXX
XXXXXXXXXXXXXXXX
XXXXXXXXXXXXXXXX
XXXX   XXXXXXXXX
XXXX   DDp   XXX
XX           XXX
XX     XX   XXXX
XX  p    p  XXXX
XX    XXXXX XXXX
XXXX XXXXXX XXXX
XXXXDXXXX    XXX
XXXXD        XXX
XXXXXXXXXXXXXXXX
XXXXXXXXXXXXXXXX