XXXXXXXXXXXX
XXXXXXXXXXXX
XX   XXXXXXX
XX     XXXXX
XXX XX XXXXX
XX  XX   XXX
XX pXX   XXX
X   XX   XXX
X p      XXX
X p     XXXX
XXXXXXXXXXXX
XXXXXXXXXXXX