XXXXXXXXXXXXXXXXXXXXX
X   XXXXXXXXXXXXXXXXX
X   XXXXXXXXXXXXXXXXX
X     XXXXXXXXXXXXXXX
X   XDXXXXXXXXXXXXXXX
X   X XXXXXXX      XX
XX XX XXXXXXX      XX
X      XXXXXX      XX
X        D         XX
X       XXXXX      XX
X       XXXXX      XX
X    p XXXXXXXXXDXXXX
X         pXXXXX XXXX
X          X      XXX
X          X      XXX
Xp     DXX X      XXX
X           XXX XXXXX
Xp             XXXXXX
XX          XXXXXXXXX
XXXXXXXXXXXXXXXXXXXXX
XXXXXXXXXXXXXXXXXXXXX