XXXXXXXXXXXXXX
XX  XXXXXXXXXX
XX         XXX
XX  Xp  XX XXX
XXX Xpp XX XXX
XXX XX XXX XXX
XX  XX XXX XXX
XX     XX  XXX
XX         XXX
XX     XX  XXX
XX     XXXXXXX
XX  XXXXXXXXXX
XXXXXXXXXXXXXX
XXXXXXXXXXXXXX