XXXXXXXXXXXXXXXXXXXXX
X    XXXXXXXXXXXXXXXX
X       XXXXXXX   XXX
X    XX XXXXXXX   XXX
XXXXXXX XXXXXXX   XXX
XXX               XXX
X    XX XXXXXXX   XXX
X       XXXXXXX   XXX
X  p    XXXXXXXX XXXX
X       XXXXXXXX XXXX
XXX     XXXX      XXX
XXX       XX      XXX
XXX XX    XX     pXXX
XXX X             XXX
XXX               XXX
XX   X           pXXX
XX   X   XXXX     XXX
XX      XXXXXXXXXXXXX
XX   XXXXXXXXXXXXXXXX
XXXXXXXXXXXXXXXXXXXXX
XXXXXXXXXXXXXXXXXXXXX