XXXXXXXXXXXXXXXXX
XXXXXXXXXXXXXXXXX
X  XXXXXXXXXXXXXX
X       XXXXXXXXX
X pX    XXXXXXXXX
XX X       XXXXXX
XX      XX XXXXXX
XX          XXXXX
XX           XXXX
XX           XXXX
XX  X X  X XXXXXX
X p   X  X XXXXXX
X           XXXXX
XX          XXXXX
XXXX  X  XXXXXXXX
XXXXXXXXXXXXXXXXX
XXXXXXXXXXXXXXXXX