XXXXXXXXXXXXXXXXXXXX
XXXXXXXXXXXXXXXp XXX
XXXXXXXXXX    X  XXX
XXXXXXXX         XXX
XXX  XXX X    X  XXX
XXX  XXX X   pXX XXX
XXX           XX XXX
XXX  XXX XXXXXXX XXX
XXXX XXX XXXXXXX XXX
XXXX XXX XXXXXXX XXX
XXXX  XX XXXXXXX XXX
XXXX        XXXX XXX
XXXXp           XXXX
XXXX       XXXXXXXXX
XXXX       XXXXXXXXX
XXXX  p  XXXXXXXXXXX
XXXX     XXXXXXXXXXX
XXXXXXXXXXXXXXXXXXXX
XXXXXXXXXXXXXXXXXXXX
XXXXXXXXXXXXXXXXXXXX