XXXXXXXXXXXXXXXX
XXXXXXXXXXXXXXXX
XXXXXXXXXXXXXXXX
XXXXXXXXXXXXXXXX
XXXXXXXX   XXXXX
XXXXXX XX XXXXXX
XXXXXX         X
XXXXXXXX  XXXX X
XXXXX XXXDXXX pX
XXXXX XXX XXX XX
DXXXX XXp XXX XX
X  XX XX XXX   X
X  XX    XXX p X
XXXX X   XX    X
XX   X  XXX XXpX
X  XXX XXXX X  X