XXXXXXXXX
XXXXXXXXX
XXXXX  XX
XX  Xp XX
XX  D DXX
XX pX pXX
XX pX  XX
XXXXXXXXX
XXXXXXXXX