XXXXXXXXXXXXXX
XXXXXXXXXXXXXX
XXXXXXXXXXXXXX
XX   XXXXXXXXX
XXpp XXXXXXXXX
XXX     XXXXXX
XXX     XXXXXX
X    X XXX  XX
X           XX
XX      XX  XX
XXXXXXXXXXXXXX
XXXXXXXXXXXXXX
XXXXXXXXXXXXXX
XXXXXXXXXXXXXX