XXXXXXXXXXXXXXXXXXXXXXX
XXXXXXXXXXXXXXXXXXXXXXX
X     XXXXXXXXXXXXXXXXX
X     XXXXXXXXXXXXXXXXX
XXX  XXXXXXXXXXXXXXXXXX
XXX  XXXXXXXXXXXXXXXXXX
X      XXXXXXXXXXXXXXXX
X      XXXXXXXXXXXXXXXX
X         XXXXXXXXXXXXX
XXXD           XXXXXXXX
X      X XXXXX XXXXXXXX
X      X XX      XXXXXX
X      X XX      XXXXXX
X      p XX      XXXXXX
X        XX     pXXXXXX
X         X      XXXXXX
X         XXXXXXXXXXXXX
X           XXXXXXXXXXX
X           XXXXXXXXXXX
X  p        XXXXXXXXXXX
X    XXXXXXXXXXXXXXXXXX
XXXXXXXXXXXXXXXXXXXXXXX
XXXXXXXXXXXXXXXXXXXXXXX