XXXXXXX XX XX
XXXXXXXXX XXX
XXXXX     XX 
XXXXXXXX  p  
XXXXX      XX
XXXXD XXXX  X
XXXX XXXXXX X
XXXXXXXXXXXD 
XXXXXXXXXXXXX
XXXXXXXXXXXXX
XXXXXXXXXXXXX
XXXXXXXXXXXXX
XXXXXXXXXXXXX