XXXXXXXXXXX
XXXXXXXXXXX
XX  XXXXXXX
XX    D XXX
XX  XXX XXX
XX  D X XXX
XXX X X XXX
XXX     XXX
XXX     XXX
XXXXXXXXXXX
XXXXXXXXXXX