XXXXXXXXXXXXXXXXXXXXXXXX
XXXXXXXXXXXXXXXXXXXXXXXX
XXXXXXXXXXXXXXXXXXXXXXXX
XXXXXXXXXXX  XXXXXXXXXXX
XXXXXXXXXXX  XXXXXXXXXXX
XXXX      XX XXXXXXXXXXX
XXXX    p XX XXXXXXXXXXX
XXXX            D    XXX
XXXX      X     XXXX XXX
X    X   XX     XXXX XXX
X    X   XXXX XXXXXX XXX
X          XX XXXXXX XXX
X p           DD XXX XXX
X      p    X     XX XXX
X           X     XX XXX
X            D    XX XXX
XXD         X     XX XXX
XX    X        XXXXX XXX
XX                   XXX
XX                   XXX
XX                   XXX
XX   p           XX  XXX
XXXXXXXXXXXXXXXXXXXXXXXX
XXXXXXXXXXXXXXXXXXXXXXXX