XXXXXXXXXXXXXXXXXXXXX
XXXXXXXXXXXXXXXXXXXXX
XXXXXXXXXXXXXXXXXXXXX
XXXXXXXXXXXXXXXXXXXXX
X    XXXXXXXXXXXXXXXX
X    XXXXXXXXXXXXXXXX
X    XXXXXX  XXXXXXXX
X p          XXXXXXXX
X      XXXX  XXXXXXXX
X            XXXXXXXX
XX     XXXX  XXXXXXXX
X      XXXX  XXXXXXXX
X p     XXX  XXXXXXXX
X            XXXX  XX
X              XX  XX
X                p XX
X                  XX
X     p       XXX  XX
XXX   XX      XXX  XX
XXXXXXXXXXXXXXXXXXXXX
XXXXXXXXXXXXXXXXXXXXX