XXXXXXXXXXXXXXXXXXXX
XXXXXXXXXXXXXXXXXXXX
XXXXXXXXXXXXXXXXXXXX
X   XXXXXXXXXXXXXXXX
X    XXXXXXXXX   XXX
X     XXX        XXX
XX    X    XXXX XXXX
XX      p      XXXXX
XX         XXXXXXXXX
XXp   X    XXXXXXXXX
XX X XX    XXXXXXXXX
XX X XXXXXXXXXXXXXXX
XX X X      pXXXXXXX
XX              XXXX
XX           XX XXXX
XX     X   pXXX XXXX
XXXXXXXX  p X    XXX
XXXXXXXXXXDD p   XXX
XXXXXXXXXXXXXXXXXXXX
XXXXXXXXXXXXXXXXXXXX