XXXXXXXXXXXXXX XXXX
XXXXXXXXXXXXX  XXXX
XXXXXXXXXXXXX  XXXX
XXXXXXXX XXXXX  XXX
XXXXXXXX XXXX     X
XXXXXXXX  XXX X  XX
XXXXXX XX  XD    XX
XXXXXX   X XXXXD p 
XXXXXXX XX XXXX XXX
XXXXXXX XX XXX  XXX
XXXXXXXDXX XXX XXXX
XXXXXXX  X DXX XXXX
XXXXXXXX     X  DXX
XXXXXX   D  XXXX  X
XXXXXX XX X XXXXX  
XXXXXX      XXXXXD 
XXXXXX      XXXXX D
XXXXXX    X XXXX   
XXXXXX      XXXX  X