XXXXXXXXXXXXXXXXXXXXXX
XXXXXXXXXXXXXXXXXXXXXX
XXX   XXXXXXXXXXXXXXXX
XXX     DXXXXXXXXXXXXX
XXX   X   XXXXXXXXXXXX
XXXX XX   XXXXXXXXXXXX
XXXX  D   XXXXXXXXXXXX
XXXX XX   XXXXXXX   XX
XXXX                XX
XXXX          XXXX XXX
XXXX  XXXXX XXXXXX XXX
XXX      XX XXXXXX XXX
XXX      X     XXXDXXX
X       XX p   XXX XXX
X              XXX XXX
Xp                XXXX
X              XXXXXXX
X              XXXXXXX
X          XXXXXXXXXXX
XXXXXX    XXXXXXXXXXXX
XXXXXXXXXXXXXXXXXXXXXX
XXXXXXXXXXXXXXXXXXXXXX