XXXXXXXXXXXX
XXXXXXXXXXXX
XXX   XXXXXX
XXXp  XXXXXX
XXX   XXXXXX
XXXX XXXXXXX
XXX    XXXXX
XX       XXX
XX   pX  XXX
XXX   D pXXX
XXXXXXXXXXXX
XXXXXXXXXXXX