XXXXXXXXXXXX 
XXXXXXXX  XX 
XXXXXXX  XXXX
XXX  XXXXXXX 
X    XXXXXXX 
D  X  XXXXXX 
XXXXX        
XXXXXX  XX XX
XXXXXXXXX   D
XXXXXXXXXXXXX
XXXXXXXXXXXX 
XXXXXXXXXXXX 
XXXXXXXXXXXX 