XXXXXXXXXXXXXX
XXXXXXXX  XXXX
XXXXXXXX  XXXX
XX  XXX   XXXX
XX        XXXX
XX  XXX   XXXX
XX    XX  XXXX
XX        XXXX
X         XXXX
X      p  XXXX
XX  p   pXXXXX
XXXX    XXXXXX
XXXXXXXXXXXXXX
XXXXXXXXXXXXXX