XXXXXXXXXXXX
XXX   XXXXXX
XXX     DXXX
XXX   X   XX
X    XX   XX
X        XXX
XX   XXX XXX
X  p XX  XXX
X        XXX
Xp   XX  XXX
XXXXXXXXXXXX
XXXXXXXXXXXX