XXXXXXXXXXXXXXXXXXXX
XX  XX  X X  XX   p 
XX        p XXX    X
XX     XXX   XXX   X
XXX XX XXX    XX X X
XXX  X        X  X  
XXXX      X XXX  X p
XXXXXX   XX  XXX    
XXXXXX   XXX XXX  XX
XXXXXX XXXXX  X     
XXXXXXXXXXXXX X XXX 
XXXXXXXXXXXXX X  XX 
XXXXXXXXXXXXX  X XX 
XXXXXXXXXXXXX XX  XX
XXXXXXXXXXXXX XX   X
XXXXXXXXXXXXX XXXX  
XXXXXXXXXXXXX XXXX  
XXXXXXXXXXXX  XXXX X
XXXXXXXXXXXXXXXXXX X
XXXXXXXXXXXXXXXXXXXX