XXXXXXXXXXXXXXXX
XXX   XXXXXXXXXX
XXX   XXXXXXXXXX
XXXX XXXXXXXXXXX
X    XXXXXXXXXXX
X    XXXXXXXXXXX
X    XXXXXXXXXXX
X    XXXXXXXXXXX
XXX   XXXXXXXXXX
XXX   XXXXXXXXXX
XXXX   XXXXX  XX
XXXX          XX
XXXXXXXXXXXX  XX
XXXXXXXXXXXXXXXX
XXXXXXXXXXXXXXXX
XXXXXXXXXXXXXXXX