XXXXXXXXXXXXXXXXXXXXXXX
XXXXXXXXXXXXXXXXXXXXXXX
XXXXXXXXXXXXXXXXXXXXXXX
XXXXXXXXXXXXXXXXXXXXXXX
XXXXXXXXX    XXXXXXXXXX
X      XX    XXXXXXXXXX
X                XXXXXX
X       X    XXX XXXXXX
XXXX  X XXX XXXX XXXXXX
XXXX  X XXX XXXX XXXXXX
XXXX    DXX XXXX XXXXXX
X   p    XX XX      XXX
X        XX XX      XXX
X        XX         XXX
X        XXXXX      XXX
X          XXXXX  XXXXX
XX         XX      XXXX
XX      XXXXX      XXXX
XX      XXXXX      XXXX
XX     XXXXXXXXXXXXXXXX
XX  XXXXXXXXXXXXXXXXXXX
XXXXXXXXXXXXXXXXXXXXXXX
XXXXXXXXXXXXXXXXXXXXXXX