XXXXXXXXX
XXXXXXXXX
XXXXXXXXX
XX  X  XX
XX     XX
XX  Xp XX
XX p   XX
XXXXXXXXX
XXXXXXXXX