XXXXXXXXXXXXXXXXXXX
XXXXXXXXXXXXXXXXXXX
XXXXXXXXXX p   XXXX
XXXXXXXXXX     XXXX
XXXXXXXXXX     XXXX
XX    XXXX     XXXX
XX      XX     XXXX
XXXX  X XXXX XXXXXX
XXXX  XD     XXXXXX
XXXX  X      XXXXXX
XXXX  X     XXXXXXX
XXXX  X     XX  XXX
XXX   X XX XXX  XXX
XX              XXX
XX        XXXX  XXX
XXX       D     XXX
XXX      XXXXXXXXXX
XXXXXXXXXXXXXXXXXXX
XXXXXXXXXXXXXXXXXXX