XXXXXXXXXXX
    XXXXXXX
XXX XXXXXXX
XXXXXXXX  X
XXXX  XX   
XXXXX    X 
XXXX XX  X 
XXX        
XXXX   X   
XXX  XXXXXX
XXX  XXXXXX