XXXXXXXXXXXXX
XXXXXXXXXXXXX
XXXXXXXXXXXXX
XXXXXXXX   XX
XXXX   X   XX
XXXX p    XXX
XXXX   X   XX
XXXXX XX   XX
X   X XXXXXXX
X          XX
X          XX
XXXXXXXXXXXXX
XXXXXXXXXXXXX