XXXXXXXX XXXXXXX
XXXX  X XX X    
XXXX  D XXDX   X
XXXX   DXX     p
XX    X XXXX   X
XX XX XDXXXX  XX
XX  XXX XXXX  XX
XX pXX    X   XX
XX XXX  X   XXXX
XX  X  XXXXXXXXX
XXXXX XXXXXXXXXX
XXXXX XXXXXXXXXX
XXXXXXXXXXXXXXXX
XXXXXXXXXXXXXXXX
XXXXXXXXXXXXXXXX
XXXXXXXXXXXXXXXX