XXXXXXXXX XXXXXXXXXXX
X  DXXXXX XXXXXXXXX  
XXXXXXXXXXXXXXXXXp   
XXXXXXXXXXXXXXXXXp   
XX   XXXXXXXXXXXX X  
XX   XXXXXXXXXXXX XX 
XXXX XXXXXX  XXXX XXX
XXXX XXXXXX   X    XX
XXXX   XXXX     XX X 
XXXXXX X  X XXX      
XXXXXX     pXXX XX  X
XXXXXX  XX  XXXXXXX  
XXXXXXXXXX XXXXXXXXXX
XXXXXXXXXXXXXXXXXXX  
XXXXXXXXXXXXXXXXX   X
XXXXXXXXXXXXX   X  XX
XXXXXXXXXX        XX 
XXXXXXXX   XD X      
XXXXXXXXX  XXXXXXXXXX
XXXXXXXXXXXXXXXXXXXXX
XXXXXXXXXXXXXXXXXXXXX