XXXXXXXXXXXXXXXXXXX
XXXXXXXXXXXX     XX
XXXXXXXXXXXX     XX
XXX    XX   XX XXXX
XXX    XX   XX XXXX
XXX         XX XXXX
XXX    XX   XXDXXXX
XXX    XXX XXX XXXX
XXXDXXXXXX XXX XXXX
XXX XXXXXX XX   XXX
X     XXXXDXX   XXX
X    p          XXX
X      X   XX   XXX
X   p     XXX   XXX
X          XXXDXXXX
X             XXXXX
X        XXXXXXXXXX
XXXXXXXXXXXXXXXXXXX
XXXXXXXXXXXXXXXXXXX