XXXXXXXXXXXXXXXXXXXXXX
XXXXXXXXXXXXXXXXXXXXXX
XXXXXXXXXXXXXXXXXXXXXX
XXXXXXXXXXXXXXXXXXXXXX
XXXX    XXXXXXXXXXXXXX
XXXX    XXXXXXXXXXXXXX
XXXX    XXXXXXXXXXXXXX
X  X    XXXXXXXXXXXXXX
X    X  XXXXXXXXXXXXXX
Xp   D    XX    XXXXXX
X  X X    XX       XXX
XXXXDX    XX    X  XXX
XXXX X    X    XX  XXX
XX  D              XXX
XX  p         XXX  XXX
XX                  XX
XX              p   XX
XX                  XX
X  XX             p XX
X pXX               XX
XXXXXXXXXXXXXXXXXXXXXX
XXXXXXXXXXXXXXXXXXXXXX