XXXXXXXXXXXXXXXXXXXXX
XXX   XXXXXXXXXXXXXXX
XXX       XXXXXXXXXXX
XXXX XXXX XXXXXXXXXXX
XXXX XXXX XXXXXXXXXXX
X    XXXX XXXXXXXXXXX
X    XXXX XXXXXXXXXXX
X p     X XXXXXXXXXXX
X       X XX      XXX
XXX             p XXX
XXX     X XX      XXX
XXX   XXX XX    p XXX
XXX     D XXXXXXXXXXX
Xp  X XXX XXXXXXXXXXX
X   X       XXXXXXXXX
X   X         XXXXXXX
X          p  XXXXXXX
X             XXXXXXX
X  XXX       XXXXXXXX
XXXXXXXXXXXXXXXXXXXXX
XXXXXXXXXXXXXXXXXXXXX