XXXXXXXXXXXXX
XXXXXXXXXXXXX
XXXXXXXXXXXXX
XXXX  XXXXXXX
XX    XXXXXXX
XX XX XX  XXX
X  XX XX  XXX
X        XXXX
XXXXX  XXXXXX
XXXXX  XXXXXX
XXXXXXXXXXXXX
XXXXXXXXXXXXX
XXXXXXXXXXXXX