XXXXXXXXXX
XXXXXX   X
XXXXXXXD  
XXXXXX    
XXXXX  X  
XXXXX  X X
XXXXX D   
XXXX   XXX
XXXXX  DXX
XXXXX   XX