XXXXXXXXXXXXXXXXXXX
XXXXXXXXXXXXX    XX
XXXXXXXX  XXX    XX
XXXXXXXX  XXX    XX
X         XXXXX XXX
X        p      XXX
X   XXXX  XXXX  XXX
XX  XXXX     X  XXX
XX  XXXX     X  XXX
X   XXXX   XXX  XXX
X      X   XXX  XXX
X    p X   XXX  XXX
X           XX  XXX
X        X  XX  XXX
X      XXXXXX   XXX
X      XXXXXX  XXXX
XXXXXXXXXXXXXXXXXXX
XXXXXXXXXXXXXXXXXXX
XXXXXXXXXXXXXXXXXXX