XXXXXXXXXXXXXXXXXXXXX
XXXXX DXXX XX  XX  XX
XXXXX XXXX  X  XX  XX
XXXXX   XXX       XXX
X  XX   XXX  X    XXX
XX                p X
XXXX XX X           X
XXXX  X X  X XXX  X X
XXXXXXX  X X XX   X X
XXXXXXXX     XX X   X
XXXXXXXX   XXX      X
XXXXXXXX        DX XX
XXXXXXXXX  X DXX XXXX
XXXXXXXXX     X  XXXX
XXXXXXXXX X   XXDXXXX
XXXXXXXXXXXXXXXXXXXXX
XXXXXXXXXXXXXXXXXXXXX
XXXXXXXXXXXXXXXXXXXXX
XXXXXXXXXXXXXXXXXXXXX
XXXXXXXXXXXXXXXXXXXXX
XXXXXXXXXXXXXXXXXXXXX