XXXXXXXXXXXXXXXXXXXX
XXXXXXXXXXXXXXXXXXXX
XXXXXXXXXXXXXXXXXXXX
XXXXXXXXXXXXXXXXXXXX
XXXXXXXXXXXXXXXXXXXX
XXXXXXXXXXXXXXXXXXXX
XXXXXXXXXXXXXXXXXXXX
XXXXXXXXXXXXXXXXXXXX
XXXXXXXXXX   XX  XXX
XXXXXXXXXX   XX  XXX
XXXX         D   XXX
XXX          XX pXXX
XXX   XXXXX XXXXXXXX
XXXXX   XXX XXXXXXXX
XX      XXX XXXXXXXX
XX      XX   XXXXXXX
XXX          XXXXXXX
XXX     XXXXXXXXXXXX
XXXXXXXXXXXXXXXXXXXX
XXXXXXXXXXXXXXXXXXXX