XXXXXXXXX
XXX  XXXX
XXX  XXXX
X  XDXXXX
Xp     XX
XX  D  XX
XX  XXXXX
XXXXXXXXX
XXXXXXXXX