XXXXXXXXXXXXXXXX
XXXXXXXXXXXXXXXX
X  XXXXXXXXXXXXX
X           XXXX
XX XXXXXXXX XXXX
XX    XX    XXXX
XX      p   XXXX
XX    XX   DXXXX
X   XXXXX X XXXX
X     XXX    XXX
X       X    XXX
X       XX   XXX
X      XX   XXXX
X           XXXX
XXXXXXXXXXXXXXXX
XXXXXXXXXXXXXXXX