XXXXXXX XXXXXXXXXXXXXXXX
X XXX   XXXXXXXXXXXXXXXX
XXXXX XXXXXXXX XXXXXXXXX
XXXXX XXXXXXX   XXXXXXXX
XXXXX XXXXXXX XXXXXXXXXX
XXXXX XXXXXXX XXXXXXXXXX
XXXX  XXXXX X XXXXXXXXXX
XXXX  XXXXX   XXXXXXXXXX
XXXXX XXXXXX  XXXXXXXXXX
XXX     XXXX  XXXXXXXXXX
XXX      XXX  XX  XXXXXX
X     XXXXXX DXX XXXXXXX
XXXX  XXXXXX     XXXXXXX
XXXX   XXXXX    XXXXXXX 
X  X XXXXXXX  X XXXXXXXX
X    XXXXXXX pX  XXXXXXX
X  XXXXXXXXX     XXXXXXX
X  XXXXXXXXX  X  XXXXXXX
X XXXXXXX  X  D  XXXXXXX
X   XXXXX XXp  DXXXXXXXX
X   XXXXX    X    XXXXXX
X   XXX    X   XX  XXXXX
X   XXXXX  p  XXXX XXXXX
X  XXXXXX      XXX XXXXX