XXXXXXXXXXXX XXXXXXXX
X X    XXXXXXXXXXX XX
X    X    XXXXXXXX XX
XX  XXXXXXXXXXXXX DXX
XX   XXXXXXXXXX    XX
XXX XXXXXXXXXXX XX XX
XXX XXXXXXXXXX   X XX
XXX XXXXXXXXXX     XX
X   XXXXXXXXXX XXXXXX
X  XXXXXXXXXXX  XXXXX
X  XXXXXXXXXXXXpXXXXX
X    XXXXXXXX     XXX
X XX XXXXXXXX  XXXX  
X XX XXXXXXXX  XXXX  
X    XXXXXXXXX XXXXX 
X   XXXXXXXXXX  XXXXX
XX  XXXXXXXXXX XXXXXX
X    XXXXXXXX   XXXXX
   X     XXXXXX XXXXX
XXXXXXX pXXXXXXXXXXXX
XXXXXXX XXXXXXXXXXXXX