XXXXXXXXXXXXXXXXXXX
XXD       X  X  XX 
XX        X XX XXXX
XXX   XX    X   XXX
XXXX   X   XXX XXXX
XX p       XXX  XXX
XXXXXX X X XXXX XXX
XXXXXX X XXXXXXXXXX
XXXXXXX   XXXXXXXXX
XXXXXXX    XXXXXXXX
XXXXXXXX  XXXXXXXXX
XXXXXXX  XXXXXXXXXX
XXXXXX   XXXXXXXXXX
XXXXXX XXXXXXXXXXXX
XXXXXX  XXXXXXXXXXX
XXXXXXXXXXXXXXXXXXX
XXXXXXXXXXXXXXXXXXX
XXXXXXXXXXXXXXXXXXX
XXXXXXXXXXXXXXXXXXX