XXXXXXXX
XXXXXXXX
XX  XXXX
XX  XXXX
X    XXX
X    XXX
XXXXXXXX
XXXXXXXX