XXXXXXXXXX
XXXXXpX  X
XXXXX   XX
XXXXX  p  
XXX   XX X
XXXX  XX  
XXXXX     
XXXXX  XXX
XXXXX     
XX    XX D