XXXXXXXXXXXXXXX
XXp XXXXX p  DX
XX    XXXX     
XXX   XXXX    D
XXXX   XXXX X  
X  X X   XX    
XX     X XX  XX
XX  XX X XX XXX
XX XX     X XXX
XX XXX  p X XXX
XXXXX   XXX  XX
XXXXXX  XXXXXXX
XXXXXX    XXXXX
XXXXXXX   XXXXX
XXXXXXX  XXXXXX