XXXXXXXXXXX
XXXXXXXXXXX
Xp XXXXXXXX
X   XXXXXXX
X   X  XXXX
X      XXXX
X   XX XXXX
X     X  XX
XX       XX
XXXXXXXXXXX
XXXXXXXXXXX