XXXXXXXXX
XX     XX
XX  X p X
XXX XX  X
XXX XXX X
XXX  X  X
XXXX  X  
XXXXX XX 
XXXXXXXXX