XXXXXXXXXXXXXXXXXXXXXX
XXXXXXXXXXXXXXXXXXXXXX
XXXXXXXXXXXXXXXXXXXXXX
XXXX   XXXXXXXXXXXXXXX
XXXX   XXXXXXXXXXXXXXX
XXXX   XXXXXXXXXXXXXXX
XXXX              XXXX
XXXX   XXXXXXXXXX XXXX
XXXX   XXXXXXXXXX XXXX
XXXXX XXXXXXXXXXX XXXX
XXXXX XXXXXXXXXXX XXXX
XX    XXXXXXXXXXX XXXX
XX   XXXX      XX XXXX
XXp  XXXX      XX XXXX
XXXXXXXXX      X   XXX
XXXXXXXXX    p X   XXX
XXXXXXXXX      X   XXX
XXXXXXXXX          XXX
XXXXXXXXX    XXX   XXX
XXXXXXXXX    XXX   XXX
XXXXXXXXXXXXXXXXXXXXXX
XXXXXXXXXXXXXXXXXXXXXX