XXXXXXXXXXXXXXX
XX    XXXXXXXXX
XX    XXXXXXXXX
XX    XXXXXXXXX
XXXX XXXXXXXXXX
XXX   XXp XXXXX
XXX       XXXXX
XX          XXX
XX        X XXX
XXXX  XX  X XXX
XXXX     XX XXX
XXXX     X  XXX
XXXX       pXXX
XXXXXXXXXXXXXXX
XXXXXXXXXXXXXXX