XXXXXXXXXXXXXXXXXX
XXXXXXXXXXXXXXXXXX
XXXXXXXXXXXXXXXXXX
XXXXXXXXXXXXXXXXXX
XXXXXXXXXXX XXXXXX
XXXXXXXXX   XXXXXX
XXXXXX  XXX  XXXXX
XXX XX  XXXX XXXXX
XXX      XXX  XXXX
XX  X     XX  XXXX
XXX    X D XX  XXX
XXXXX      XX  XXX
XXXXX    D XX XXXX
XXXXX   X XX  XXXX
XXXXX   X XX  XXXX
XXXXX  X  XXX XXXX
XXX  D     XX  DXX
XXX  XDX      X XX