XXXXXXXXXXXXXXXXXXXXXXX
XXXX   XXXXXXXXXXXXXXXX
XXXXXDXXXXXXXXXXXXXXXXX
XXX   XXXXXXXXX XXXXXXX
XXX   DXXXXXX   XXXXXXX
XXX  X XXXXXX XXXXXXXXX
XXX XX XXXXXX XXXXXXXXX
 XX  X XXXXXX  XXXXXX X
XXXX X  XXXXX DXXXXXX  
XXXX XX XXX   XXXXXXX  
XXXX    XXXX XXXXXXXX  
XXXXXX   XXX XXXXXXXX X
XXXXXX   XXX XXXXXXXXpX
XXXXXX   XXXDXXXXXXX  X
XXXXX  X XXX XXXXXX   X
XXXX     XXX  XXXXX XXX
  XX   XXXXX pXXX    XX
X XX    XXXXX XXXpX  XX
X  X    XXXXX X   XX   
X  XD    XXXX   XXXX XX
X   XX   XXXXX        X
X      p  XXXX  X   X X
X XX      XXXXD X X X X