XXXXXXXXXXXXXXXXX
XXXXXXXXXXXXXXXXX
XXXXX  XXXXXXXXXX
XXXXX    XXXXXXXX
XXXXX  X XXXXXXXX
XXXXXXD   XXXXXXX
XXXXXX    XXXXXXX
XXXXXXXX XXXXXXXX
XXXXXXXX XXXXXXXX
X  XXXXX XXX   XX
X          D   XX
X  X     XXXXDXXX
XXXX   p     XXXX
XXXXXXXXXXXXXXXXX
XXXXXXXXXXXXXXXXX
XXXXXXXXXXXXXXXXX
XXXXXXXXXXXXXXXXX