XXXXXXXX
XXXX  XX
XX    XX
X  XXXXX
X pXXXXX
XXXXXXXX
XXXXXXXX
XXXXXXXX