XXXXXXXXXXXXXXXXXXXXXXX
XXXXXXXXXXXXXXXXXXXXXXX
XXXXXXXXXXXXXXXXXXXXXXX
XXXXXXXXXXXXXXXXXXXXXXX
XXXXXXXXXXXXXXXXXXXXXXX
X     XXXXXXXXXXXXXXXXX
X                 XXXXX
XXX   p    XX     XXXXX
X          XX     XXXXX
X     p    XX     XXXXX
X        XXXX     XXXXX
X             p   XXXXX
XX            XX XXXXXX
XX     X        XXXXXXX
XX            XXXXXXXXX
XX              XXXXXXX
XXX             XXXXXXX
XXX  p   X      XXXXXXX
XXX           XXXXXXXXX
XXXX          XXXXXXXXX
XXXXXXXXXXXXXXXXXXXXXXX
XXXXXXXXXXXXXXXXXXXXXXX
XXXXXXXXXXXXXXXXXXXXXXX