XXXXXXXXXXXXX
XXXXXXXXXXXXX
XXXX  XXXXXXX
XXXX  XXXXXXX
XXXX  XXXXXXX
XXXX  XXXXXXX
XXXD  XXXXXXX
XXX X XXXXXXX
XX       XXXX
X        XXXX
X    p XXXXXX
XXXXXXXXXXXXX
XXXXXXXXXXXXX