XXXXXXXXXXXXX
XXXXXXXXXXXXX
XXXXXXXXXXXXX
XXXXXXXXXXXXX
X   XXXXXXXXX
X   XXXXXXXXX
X   XXXXXXXXX
XX      XXXXX
X   XX  X  XX
X          XX
XXXXXXXXX  XX
XXXXXXXXXXXXX
XXXXXXXXXXXXX