XXXXXXXXXXXXXXX
XXXXXXXXXXXXXXX
XXXXXXXXXXX XXX
XXXXXXXXXXX  XX
XXXXXXXXXX   XX
XXXXXXXXXXX XXX
X XXXXXXXXX XXX
X XXXXXXXXX   X
X  D  XXXXXXX X
XXX   XXXXXXX  
XXXX   XXXXXX  
XXX  X  XXXXXX 
X   XXXDXXXXXX 
XX  XXX  XXXXXX
X  XXXX  XXXX  