XXXXXXXXXXXXXXXXXXX
XXXXXXXXXXXXXXXXXXX
XXXXXXXXXXXXXXXXXXX
XXXXXXXXXXXXXXXXXXX
Xp   X   XXXXXXXXXX
X           XXXXXXX
X    X   XX XXXXXXX
XXX XXX XXX XXXXXXX
XXX XXX XX   XXXXXX
XXX p X XX   XXXXXX
XXX     XX   XXXXXX
XXX   X XX   XXXXXX
XXX  X   X   XXXXXX
XXX      XXXXXXXXXX
XXXX    XXXXXXXXXXX
XXXX    XXXXXXXXXXX
XXXXXXXXXXXXXXXXXXX
XXXXXXXXXXXXXXXXXXX
XXXXXXXXXXXXXXXXXXX