XXXXXXXXXXXXX
XXXXXXXXXXXXX
XXp  XXXXXXXX
XX   XXXXXXXX
XXpp XXX   XX
X p        XX
X          XX
X        X XX
X      XXX XX
XX X   XX  XX
XX    p    XX
XXXXXXXXXXXXX
XXXXXXXXXXXXX