XXXXXXXXX
XXXXXXXXX
XXXXXXXXX
X  XXXXXX
X  X  XXX
X    pXXX
X  XXXXXX
XXXXXXXXX
XXXXXXXXX