XXXXXXXXXXXXXXXXX
XXXXXXXXXXX XX   
XXXXXXXX XX X   X
X D         XX D 
XXX DXXX   XX   X
XXXXXXXXXX  X XXX
XXXXXX XXX    XXX
XXXXX           X
XXXX   XX   D    
XXXX X     XX X X
XXX  XXXXXXXX  XX
XXXXXXXXXXXXXX   
XXXXXXXXXXXXXXXXX
XXXXXXXXXXXXXXXXX
XXXXXXXXXXXXXXXXX
XXXXXXXXXXXXXXXXX
XXXXXXXXXXXXXXXXX