XXXXXXXXXXXXXXXXX
XXXXXXXXXXXXXXXXX
XXXXXXXXXXXXXXXXX
XXXXXXXXXXXXXXXXX
XXXXXXXXXXXXXXXXX
XXXXXXXX pXXXXXXX
XXXXXXXX  XXXXXXX
XXXXXXXX  XXXXXXX
XXXXXXXXp XXXXXXX
XXXXXXXXX XXXXXXX
XXXXXX     pXXXXX
XXXXXX p     XXXX
XX  XXXX     XXXX
XX   D  XXXXXXXXX
XXXXXXXXXXXXXXXXX
XXXXXXXXXXXXXXXXX
XXXXXXXXXXXXXXXXX