XXXXXXpXXXXXXXXXXXXX
XXXXXX XXXXXXXXXXXXX
XXXXX  XXXXXXXXXXXXX
XXXXX  XXXXXXXXXXXXX
X XXXX        XXXXXX
X XXXX  X    XXXXXXX
XpXXXXX X   XXXXXXXX
X XXXXX XX   XXXXXXX
XXXXXX  XX X XXXXXXX
XXXXXX  XX XDXXXXXXX
XXXX X XX  X XXXXXXX
XXXX   XX XX   XXXXX
XXXX   XX  XX  XXXXX
XXXXXX    XXX XXXXXX
XXXXXX    XX    XXXX
XXXXX     XXX  DXXXX
X  X       X  XXXXXX
X  X       X  XXXXXX
X         X   XXXXXX
 XX XX    XX  XXXXXX