XXXXXX XXXXXXXXXXXXXX
XXX  XXXXXXXXXXXXXXXX
XXXXXXXXXXXXXXXXXXXXX
XXXXXXXXXXXXXXXXXXXXX
XXXXXXXXX   XXXXXXXXX
XXXXXXXX  X  XXXX    
XXXXXXXXXXX        XX
XXXXXXXXXXXX  XX  pXX
XXXXXXXXXXXX         
       XXX           
XXX XX         X    X
XXXXXX   XXXXXX D    
XXXX      XXX      XX
XXXXX  XX     XXX  p 
X      XXX   XXXX X  
XXXXXXXXXXXXXXXXXXXXX
XXX    XXXXXXXXXXXXXX
X   XX   p        XXX
 DXXXX  XXXXXXXXX    
XXXXXXXXXX  XXXXXXXXX
XXXXXXXXXXX XXXXXXXXX