XXXXXXXXXXXXXX
X   XXXXXXXXXX
X       XXXXXX
XX XXXX XXXXXX
XX X  X XXXXXX
X  X  X XXXXXX
X     X XXXXXX
X   X X XXXXXX
X     X XXXXXX
X        XXXXX
X        XXXXX
XXXX   XXXXXXX
XXXXXXXXXXXXXX
XXXXXXXXXXXXXX