XXXXXXXXXXXXXX
XXXXXXXXXXXXXX
XXXXXXXXX  XXX
XX         XXX
XX XXXXXXX XXX
XX  XXXXXX XXX
X    XXXXX XXX
X    XXXX   XX
X  X X  X   XX
X       X   XX
X         XXXX
XXX   XXXXXXXX
XXXXXXXXXXXXXX
XXXXXXXXXXXXXX