XXXXXXXXXXXXXXX
XXXXXXXXXXXXXXX
XXXXXXXXXXXXXXX
XXXXX    XXXXXX
XXXXX    XXXXXX
XXXXX    XXXXXX
XXXXX   XXXXXXX
XXXXX   XXXXXXX
XXXXp    XXXXXX
XXXX     XXXXXX
X     XXXXXXXXX
X        XXXXXX
XXXXX    XXXXXX
XXXXXXXXXXXXXXX
XXXXXXXXXXXXXXX