XXXXXXXXXXXXXXXXX
XXXXXXXXXXXXX  XX
XXXX      D    XX
XXXX    XXXXXX XX
XXXX    XXXXXX XX
XXXX X  XXXXX  XX
XXX            XX
X    X  XXXXX  XX
X    X  X  XXX XX
X p   X X  XXX XX
X   p          XX
XX        XXXX XX
XX            XXX
XX p      XXXXXXX
XX       XXXXXXXX
XXXXXXXXXXXXXXXXX
XXXXXXXXXXXXXXXXX