XXXXXXXXXXXXX
XXXX   XXXXXX
XXXX   XXXXXX
XXXX   X   XX
XXXXX      XX
XX  XXXX   XX
X     X   XXX
X          XX
X    XX  X XX
XXX  XXXX  XX
XXX        XX
XXXXXXXXXXXXX
XXXXXXXXXXXXX