XXXXXXXXXXXXXXXXXXXXXXXX
XXXXXXXXXXXXXXXXXXXXXXXX
XXXXXXXXXXXXXXXXXXXXXXXX
XXXXXXXXXXXXXXXXXXXXXXXX
X    XXXXXXXXXXXXXXXXXXX
X             D XXXXXXXX
X      XXXXXXXX XXXXp XX
XX     XXXXXXXX XXXX  XX
XX         XXXX XXXX  XX
XX              D     XX
XX     XXX XXXX XXXX  XX
XXXX XXX     XX XXXX  XX
XXXX XXX     XX XXXXX XX
XXXX X       XX XXXXX XX
XXXX X          D    XXX
XXXX X          XXXXXXXX
XXXX XXX    p     XXXXXX
XXXX XXX          XXXXXX
XXXX             pXXXXXX
XXXXXXXX          XXXXXX
XXXXXXXX     XXXXXXXXXXX
XXXXXXXX     XXXXXXXXXXX
XXXXXXXXXXXXXXXXXXXXXXXX
XXXXXXXXXXXXXXXXXXXXXXXX