XXXXXXXXXXXXXXXXXXXXX
XXXXXXXXXXXXXXXXXXXXX
XXXXXXXXXXXXXXXXXXXXX
X     XXXXXXXXXXXXXXX
X     XXXXX      XXXX
X     XXXXX      XXXX
XXX X  XXXX      XXXX
XXX X  XXXX     pXXXX
XXX X  XXXX      XXXX
XXX X            XXXX
XXX X pXXXXXXX XXXXXX
XXX X  XXXXXXX XXXXXX
XXX    XXXXp     XXXX
XXX         p    XXXX
XXX XX           XXXX
XXX      XX      XXXX
XXXXXX   XXXXXXXXXXXX
XXXXXX   XXXXXXXXXXXX
XXXXXXX  XXXXXXXXXXXX
XXXXXXXXXXXXXXXXXXXXX
XXXXXXXXXXXXXXXXXXXXX