XXXXXXXXXXXXXX XXXXXXXXX
XXXXXXXXXXXXX  XXXXXXXXX
XXXXXXXXXXXXX  XXXXXXXXX
X   XXXXXX XXX XXXXXXXXX
X XXXXXXX DXXX XXXXXXXXX
X  XXXXXXX     XX XXXXXX
XXXXXXXXXX  XXX   XXXXXX
XXXXXXXXXX  XXXX XXXXXXX
XXXXXXXXX     XX XXD  XX
XXXXXXXXX XXX    XXX XXX
XX XXXXXX  XX X  XXX XXX
XX XXXXX X    XX XXX  XX
X                 XXX  X
XXXX     XX  XXXX XXXX X
XX       XX XXXXX XXX   
XX  p   X    X  X XXXXXX
XX X p  X XXXXX X XXXXXX
XX XX   X XXXXX   XXXXXX
XX  X     XXXXXXX  XXXXX
X      X  XXXX p  XXXXXX
XXXX     XXXXX X  XXXXXX
XXXX      XXXX XX XXXXXX
XXXX      XXX   X  XXXXX
XXXX XXp XXXX XXXX XXXXX