XXXXXXXXX
X  XXXXXX
X pDXXXXX
X   XXXXX
X   X  XX
X     pXX
X  XXXXXX
XXXXXXXXX
XXXXXXXXX