XXXXXXXXXXXXXXX
X    XXXXXXXXXX
X   pD    XXXXX
XX    XXX XXXXX
XX    XXX XXXXX
X p  XXXX XXXXX
Xp         XXXX
X      XX   XXX
XX    p     XXX
XXDX   XX XXXXX
X    XX   XXXXX
X      p  XXXXX
XXXXXXXX  XXXXX
XXXXXXXXXXXXXXX
XXXXXXXXXXXXXXX