XXXXXXXXXXXXXXXXXXXX
X    X   XXXX XXXXXX
X    XXX      XXXXXX
X        XXX  XXXXXX
X     XX XXX  XXXXXX
XX       XXXXDXXXXXX
XXX     XX D  XXXXXX
XXX     XXXX  XXXXXX
 X      XX   XXXXXXX
 XXp  X XXXXXXXXXXXX
XXXXX X XXXXXXXXXXXX
XXXXX XXXXXXXXXXXXXX
XXXXXXXXXXXXXXXXXXXX
XXXXXXXXXXXXXXXXXXXX
XXXXXXXXXXXXXXXXXXXX
XXXXXXXXXXXXXXXXXXXX
XXXXXXXXXXXXXXXXXXXX
XXXXXXXXXXXXXXXXXXXX
XXXXXXXXXXXXXXXXXXXX
XXXXXXXXXXXXXXXXXXXX