XXXXXXXXXXXXXXXXXX
XXXXXXXXXXXXXXXXXX
XXXXXXX     XXXXXX
XXXXXXX     XXXXXX
XXXXXXX     XXXXXX
XXXXXXXXX XXXXXXXX
XXXX  XXX XXXXXXXX
XXXX     XXX  XXXX
XXXX  XXXXXX pXXXX
XXX           XXXX
XXX X XXXXXX  XXXX
XX  X   XXXX  XXXX
XX  X   XXXXX XXXX
XX          X XXXX
XX  X        XXXXX
XXXXXXXXXXXXXXXXXX
XXXXXXXXXXXXXXXXXX
XXXXXXXXXXXXXXXXXX