XXXXXXXXXXXXXXXXXXXXX
XXXX  XXXXXXXXXXXXXXX
XXXX     D    XXXXXXX
XXXX  XXXXXXX XXXXXXX
XXXXX XXXXXXXDXXXXXXX
XXXXX XXXXX    XXXXXX
XXX     pXX    XXXXXX
XXX p   p      XXXXXX
XXX     p X    XXXXXX
XXX       X    XXXXXX
XXX  p    X    XXXXXX
XXX       XX XXX  XXX
XXX   p p        pXXX
XXX          XXX  XXX
XXX    XXXX  XXXX XXX
XXX  p XXXX  XXXX XXX
XXXX     p   XXXX XXX
XXXX     p       XXXX
XXXX   XXXXXXXXXXXXXX
XXXXXXXXXXXXXXXXXXXXX
XXXXXXXXXXXXXXXXXXXXX