XXXXXXXXXXX
XXXXX  XXXX
XXXXXp XXXX
XXXXXX XXXX
X  XXX  XXX
X       XXX
XX    XXXXX
XXXXXXXXXXX
XXXXXXXXXXX
XXXXXXXXXXX
XXXXXXXXXXX