XXXXXXXXXXX
XXXXXXXXXXX
XXXXXXXXXXX
XXXX  XXXXX
XXXX  XXXXX
X   X X  XX
X        XX
X       XXX
X    XXXXXX
XXXXXXXXXXX
XXXXXXXXXXX