XXXXXXXXXXX
XXXXXXXX  X
XXXXXXXXX X
XXXX  XX pX
XXXXX X   X
XXXXX  XX X
XXXXXXDXX X
  DXX  XXDX
X  XX      
X        XX
X  X XXX  X