XXXXXXXXXXXXXXX
XX   XXXXXXXXXX
XX  pXXXXXXXXXX
XX  XXXXXXXXXXX
XX     XXXXXXXX
XXX     XXXXXXX
XXX        XXXX
XXX     XXDXXXX
XXX X  XXX XXXX
XX     X    XXX
Xp          XXX
X           XXX
XX          XXX
XXXXXXXXXXXXXXX
XXXXXXXXXXXXXXX