XXXXXXXXXXXXXXXXXX
XXXXXXXXXXXXXXXXXX
XXX   XXXXXXXXXXXX
XXX   XXXXXXXXXXXX
XXXX XXXXXXXXXXXXX
XXXX XXXXXXXXXXXXX
X     XXXXXXXXXXXX
X     XXXXXXXXXXXX
X             XXXX
X     XXXXXXX XXXX
X          XX XXXX
X          X  XXXX
X          X  XXXX
X             XXXX
X          X  XXXX
X p     XXXXXXXXXX
XXXXXXXXXXXXXXXXXX
XXXXXXXXXXXXXXXXXX