XXXXXXXX
XXXXXXX 
XXXXXXX 
XXXXXXX 
XXXXXX  
XXXXXX  
XXXX    
XXXXXXX 