XXXXXXXXXXXXXXXXXXXX
XXX  X   X    XXXXXX
XXX XX       XXXXXXX
XXX  p   X  XXXXXXXX
XXXXX X      XXXXXXX
XXXXX X   p   XXXXXX
XXXXX p       XXXXXX
XXXXX  X   XX   XXXX
XXXXX  X  XXX    XXX
XXXXX      XX XX XXX
XXXXX   X  XXXXX  XX
XXXXX XX  XXXXXX  X 
XXXXX XXXpXXXXXX XX 
XXXXX  XXXXXXXXX X  
XXXXXX  XXXXXXXXXX X
 XXXXXX XXXXXXXXXXXX
XXXXXXXXXXXXXXXXXXXX
XXXXXXXXXXXXXXXXXXXX
XXXXXXXXXXXXXXXXXXXX
XXXXXXXXXXXXXXXXXXXX