XXXXXXXXXXXXXXXXXXXXXX
XXXXXXXXXXXXXXXXXXXXXX
XXXXXXXXXXXXXXXXXXXXXX
X     XXXXXXXXXXXXXXXX
X     D  XXXXXXXXXXXXX
Xp    XX XXXXXXXX   XX
XXXp XXXDXXXXXXXX   XX
XXX pXXX XXXXXXXX   XX
XXX  XXX XXXXXXXX p XX
XX     p            XX
X         DXXXXXXXXXXX
X        X XXXXXXXXXXX
X          X      XXXX
X          X      XXXX
X     p           XXXX
X                 XXXX
X                 XXXX
XX      XXXXXXX    XXX
XX      D          XXX
XX      XXXXXXXXXXXXXX
XXXXXXXXXXXXXXXXXXXXXX
XXXXXXXXXXXXXXXXXXXXXX