XXXXXXXXXXXXXXXXXXXXXX
XXXXXXXXXXXXXXXXXXXXXX
XXXXXXXXXXXXXXXXXXXXXX
XXXXXXXXXXXXXXXXXXXXXX
XXXXXXXXXXXXXXXXX XXXX
XXXXXXXXXXXXXXXX      
XXXXXXXXXXX        XX 
XXXXXXXXXXXX XX    X  
XXXXXXXXXXXXXXXXXX   X
XXXXXXXXXXXXXXXX      
XXXXXXXXXXXXXXXXX X   
XXXXXXXXXXXXX XX  X   
XXXXXXXXXXXXX  X   p  
XXXX     XXXX       XD
XX   XXX      XXX     
XX XXXXXX             
XX XXXXXXXX XX    XXXX
X  XXXXXXXXXXXXXXXXXXX
XXXXXXXXXXXXX X       
XXXXXXXXXXXXX   X   X 
XXXXXXXXXXXXXXX XXXXXX
XXXXXXXXXXXXXXXXXXXXXX