XXXXXXXXXXX
XXXXXXXXXXX
XXX  XX  XX
XXX      XX
XX  XXX  XX
XX  XXX  XX
X p  XXX XX
X       XXX
XX    pXXXX
XXXXXXXXXXX
XXXXXXXXXXX