XXX XXXXX
XXXXXXXXX
XXXXXXXXX
XXXXXXXXX
XXXXXXXXX
XXXXX   X
XXXXX    
XX    D X
X   X   X