XXXXXXXXXXXXXXXXXXXXX
XXXXXXXXXXXXXXXXXXXXX
XXXXXXXXXXXXXXXXXXXXX
XXXXXXXXXXXXXXXXXXXXX
XXXXXXXXXXXXXXXXXXXXX
X    XXXXXXXXXXXXXXXX
X          XXXXXXXXXX
XXX XXX      XXXXXXXX
XX   XX      XXXXXXXX
XXp          XXXXXXXX
XX             XXXXXX
XX   X    p  X XXXXXX
XX   X   XX      XXXX
XX       XX      XXXX
XX        X      XXXX
XX               XXXX
XX         p     XXXX
XXX              XXXX
XXXXXXXXXXXXXXXXXXXXX
XXXXXXXXXXXXXXXXXXXXX
XXXXXXXXXXXXXXXXXXXXX