XXXXXXXXXXXXXXX
XXXXXXXXXXXXXXX
XXXXXXXXXXXXXXX
XXXXXXXXXXXXXXX
XXXX   XXXXXXXX
XXXX   XXXXXXXX
XX     XXXXXXXX
XX X   X  pXXXX
X      X   XXXX
X      XX XXXXX
X        DXXXXX
X         XXXXX
XX   Xp  XXXXXX
XXXXXXXXXXXXXXX
XXXXXXXXXXXXXXX