X XXXXXX
X XXXXXX
X XXXXXX
X   XXXX
XXX  XXX
XXXXDXXX
XXX  XDX
XXX    X