XXXXXXXXXXXXXXXXXX
XXXXXXXXXXXXXXXXXX
X  XXXXXXXXXXXXXXX
X  XXXXXXXXXX   XX
X               XX
X  X    XXX     XX
X p     XXX X   XX
X      XXX  X   XX
X             XXXX
X             XXXX
X             XXXX
X        XXXX XXXX
X        XXX   XXX
XXX            XXX
XXXX      XX   XXX
XXXX      XXXXXXXX
XXXXXXXXXXXXXXXXXX
XXXXXXXXXXXXXXXXXX