XXXXXXXXXXXXXXXXXXXXXX
X  XXXXXXXXXXXXXp  XXX
X  XXXXXX          XXX
X  XXX         X   XXX
X           p  XX XXXX
X  XXX X XX  XXXX XXXX
X  XXX X XX  XXXX XXXX
XX XXXDX XX  XXXX XXXX
X        XX DXXXX XXXX
X            XXXX XXXX
X p          XXXX XXXX
X       D       DXXXXX
X     X  XX  XXXXXXXXX
X     X  XX  XXXXXXXXX
X   XXX       X    XXX
X             X    XXX
X             D    XXX
X   X              XXX
XXXXX      XXXXXXXXXXX
XXXXX     XXXXXXXXXXXX
XXXXXXXXXXXXXXXXXXXXXX
XXXXXXXXXXXXXXXXXXXXXX