XXXXXXXXXXXXXXXXXXXXXXX
XXXXXXXXXXXXXXXXXXXXXXX
XXXXXXXXXXXXXXXXXXXXX X
XXXXXXXXXXXXXXXXXXXXX  
XXXXXXXXXXXXXX   XXXXXX
XXXXXXXXXXXXXX X  XXXXX
XXXXXXXX   XX  XX      
XXXXXXXX X  X   D     X
XXXXXX        X     XX 
XXXX      XX  X X      
XXXXX        X  p   D  
XXXXXXXXX  X        D  
XXXXXXXXX X X          
XXXX   X  X       XX   
XXXX X      XXD       p
XXX      XXXXXp  p     
XXXXXX XXXXXXXXXXX XXX 
XXXXXXXXXXXXXXXXXXXXXX 
XXXXXXXXXXXXXXXXXXXXXX 
XXXXXXXXXXXXXXXXXXXXXX 
XXXXXXXXXXXXXXXXXXXXXX 
XXXXXXXXXXXXXXXXXXXXXX 
XXXXX XXXXXXXXXXXXXXXX 