XXXXXXXXXXXXXXXXX
XXXXXXXXXXXXXXXXX
XXXXXXXXXXXXXXXXX
XXXXXXXXXXXXXXXXX
X    X    XXXXXXX
X    X  p X   XXX
X    X    X   XXX
X     X    p  XXX
XX     p  X   XXX
XX         D   XX
XX       XXX   XX
XX          D  XX
XX             XX
X           X  XX
X          XXXXXX
XXXXXXXXXXXXXXXXX
XXXXXXXXXXXXXXXXX