XXXXXXXXXXX
X pXXXX  XX
X  XD    XX
X  X XXXDXX
X        XX
X    XX  XX
X        XX
X   p   XXX
XX    XXXXX
XXXXXXXXXXX
XXXXXXXXXXX