XXXXXXXXXXXXXXXXXXXXX
XXXXXXXXXXXXXXXXXXXXX
XXXXX   XXXXXXXXXXXXX
XXXXX   XXXXXXXXXXXXX
XXXXXX XXXXXXXXXXXXXX
XX      XXXXXXXXXXXXX
XX      XXX      XXXX
XX        X      XXXX
XX        XXXXDXXXXXX
XX         D D   XXXX
XX        XXXX X XXXX
XX      X XXXX XDXXXX
X     p    XXX X XXXX
X     p      X XDXXXX
X            X X XXXX
X   p       XXDX XXXX
X           X   p  XX
XXXX    p          XX
XXXX          XXXXXXX
XXXXXXXXXXXXXXXXXXXXX
XXXXXXXXXXXXXXXXXXXXX