XXXXXXXXXXXX
XXXXXXX   XX
XXXXXXXX    
X XXXX   XXX
X  XXX  XXXX
XX  XX  XXD 
XXX XX XXX  
XXXXXXXXXX X
XXXXXXXXX  X
XXXXXXXXX XX
X  XXXXXX  X
XXXXXXXXXXXX