XXXXXXXXXXX X
XX XXXXXXXXXX
XX XXXXXXXXXX
XXXXXXXXXXXXX
XXXXXXXXXXX  
XXXXXXXXXX   
XXXXXXXXXX XX
XXXXXX XXX XX
XXXXXX       
  XXXXX    XX
X p p   XXXXX
XX XXXXXXXXXX
XX XX   XXXXX