XXXXXXXXXXXXXXXXXXXXXX
XXXXXXXXXXXXXXXXXXXXXX
XXXXXXXXXXXXXXXXXXXXXX
XXXXXXXXXXXXXXXXXXXXXX
XXXXXXX  XXXXXX XXXXXX
XXXXXXX XXXXXXX XXXXXX
XXXXXXX   XXXXXDXXXXXX
XXXXXXXX XXXXXX XXXXXX
XXXXXXXX   XXXX  XXXXX
X XXXXXXX XXXXXX XXXXX
XXXXXXXXX XXXXXX XXX X
XXXXXXXX  XXXXXX  X   
XXXXXXXXX XXXXXX X    
XXXXXXXXXp XXXXX DX X 
XXXXXXXXX XXXXXX XX XX
XXXXXXXX  XXXXXX  X XX
XXXXXXXX XXXXX   XX  X
X X  p    XXX    XX  X
X XX    X XXXXX     XX
X XX      XXX   X X  X
Xp XXD   XXXX XXX  X X
    Xp XXXXX  XXXX X X