XXXXX XXX X
XXXXXXXXX  
XD XXXX    
X X XXX    
X X XXX  XX
X   XX  XXX
X  XXXDXXXX
X  XXX  XXX
X XXXXX  XX
X XXXXX   X
X  XXX  XXX