XXXXXXXXXXXXXXXXXXXXXXX
XXXXXXXXXXXXXXXXXXXXXXX
XX     pXXXXXXXXXXXXXXX
XX               XXXXXX
XXXX   XXXX      XXXXXX
XXXX   XXXX      XXXXXX
XXXX     XX pp   XXXXXX
X  X   X XX      XXXXXX
X  XX XX XX p    XXXXXX
X           XXXXXXXXXXX
X  XX XX     XX    XXXX
Xp           XX    XXXX
X           D      XXXX
X         XXXXX    XXXX
X         XXXXX   XXXXX
X    p p  XXXXX   XXXXX
X           XXX   XXXXX
X                XXXXXX
X   p p          XXXXXX
X      XX XXXXX  XXXXXX
X        XXXXXXXXXXXXXX
XXXXXXXXXXXXXXXXXXXXXXX
XXXXXXXXXXXXXXXXXXXXXXX