XXXXXXXXXXXXXXXXXXX
XXXXXXXXXXXXXXXXXXX
XXX     XXXXXXXXXXX
XXX     XXXXXXXXXXX
XXX     XXXXXXXXXXX
XXX     XXXXXXXXXXX
XXX    XXXXXXXXXXXX
XX     XXXXXXXXXXXX
XX     XXXXXXXXXXXX
X        D   XXXXXX
X      XXXX   XXXXX
X             XXXXX
X        XX   XXXXX
X     p  XXXXXXXXXX
X        XXXXXXXXXX
X        XXXXXXXXXX
XXXXXX   XXXXXXXXXX
XXXXXXXXXXXXXXXXXXX
XXXXXXXXXXXXXXXXXXX