XXXXXXXXXXX
XXXXX   XX 
XXXXX   pXX
XXXX     XX
XXXXXXD    
XXXXXXXX XX
X XXXXXXXXX
XXXXXXXXXXX
XXXXXXXXXXX
XXXXXXXXXXX
XXXXXXXXXXX