XXXXXXXXXXXXXX
XXXXXXXXXXXXXX
XXXXXXXX  XXXX
XXXX      XXXX
XXXX XXX  XXXX
XX   XXX  XXXX
XX    D   XXXX
XX    XXX XXXX
XXX    XX XXXX
X   p     XXXX
X  p     XXXXX
X  X  pXXXXXXX
XXXXXXXXXXXXXX
XXXXXXXXXXXXXX