XXXXXXXXXXXXXXXXXXX
XXXX XXXXXXXXXXXXXX
XXXX XXXXXXXXXX XXX
XXXX XXXXXXXXX   XX
XXXXDXXXXXXX     XX
XXX  XXXXXXXX  p  X
XXX XXXXXXX    XXXX
XXX XXXXXXX    XXXX
XXX  XXXXXX   XXXXX
XXXX XXXXX     XXXX
XX   XX  XX   XXXXX
XX XXXX   Xpp  XXXX
XX XXXX   X     XXX
XX  XXX   XX X  XXX
XXX XXX X    X  XXX
XX  XX          XXX
XX XXX XX  X    DXX
XX XXX     XX    XX
XX XXX   p         