XXXXXXXXXXXXX
XX  XXXXXXXXX
XX    pXXXXXX
XXX    XXXXXX
XXX  p XXXXXX
XX    DXXXXXX
XX      D XXX
XX   X XXDXXX
XX   X X   XX
XX   X     XX
XXXXXXXX   XX
XXXXXXXXXXXXX
XXXXXXXXXXXXX