XXXXXXXXXXXXXXXXXX
XXXXXXXXXXXXXXXXXX
XXXXXXXXXXXXXXXXXX
X   XXXXXXXXXXXXXX
X        XXXXXXXXX
X   X  X XXXXXXXXX
XX XX  D    XXXXXX
XX XX  X    XXXXXX
XX XX  X XXXXXXXXX
XXDXX  X X    XXXX
XX X    D     XXXX
XX        XX XXXXX
XX   p    X  XXXXX
XX           XXXXX
XX  X    pX  XXXXX
XX  X       XXXXXX
XXXXXXXXXXXXXXXXXX
XXXXXXXXXXXXXXXXXX