XXXXXXXXXXX
XXXXXXXXXXX
XXXXXXXXXXX
X  XXXXXXXX
X   DXXXXXX
XX   XXXXXX
XX    D  XX
X    XX  XX
X  p XXXXXX
XXXXXXXXXXX
XXXXXXXXXXX