XXXXXXXXXX
XXXXXXXXXX
XXXXXXXXXX
XXXXXX  XX
XXX     XX
XXX  XX XX
XXXX  X XX
XXXX   XXX
XXXXXXXXXX
XXXXXXXXXX