XXXXXXXXXXXXXXXXX XX
XXXXX   X     XXXXXX
XXXXXXX      XXXX   
XXXXXXX XXXX  XX  X 
XXXXXXX XXXXX    X  
XX      XXXXXX  X  X
XXX   XXXXXXXX      
XXXXXX XXXXXXX XX X 
XXXXD          XX XX
XXXXXXX    X XXXX XX
XXXXXXXXXXXX XX   XX
XXXXXXXXXX X  D  X  
XXXXXXXX   XXXXp    
XXXXXX   X          
XXX     XXXX X     X
XXX  XXXXXXXXXXXXXXX
XXXX XXXXXXXXXXXXXXX
XXXXXXXXXXXXXXXXXXXX
XXXXXXXXXXXXXXXXXXXX
XXXXXXXXXXXXXXXXXXXX