XXXXXXXXXXXXXXXX
XXXXXXXXXXXXXXXX
XX    XXXXXXXXXX
XX    XXXXXXXXXX
XXXX XXXXXXXXXXX
XXXX XXXXXXXXXXX
XX    XXX   XXXX
XX    XXX   XXXX
XX      D   XXXX
XX    XXXXXXXXXX
XX      XX  XXXX
XX          XXXX
XX         XXXXX
XXXXX   XXXXXXXX
XXXXXXXXXXXXXXXX
XXXXXXXXXXXXXXXX