DXXXXXXXXXXXXX
XXXXX  XXX  XX
X     XXXX XXX
XXXXXXX    DXX
XXXXXXX X Xp X
XXXXXXX   X  X
XXXX    XXX   
XXXX          
 XXXX  XXX   X
XXXXX  XXX XXX
XXXXXXXXXXXXXX
XXXXXXXXXXXXXX
XXXXXXXXXXXXXX
XXXXXXXXXXXXXX