XXXXXXXXXXXXXXXXXXXXXXXX
XXX    XX XXXXXXX XX    
XXX    XX XXXXXXX X    X
XXX    XX   XXXX    X  X
XXXX  XXXXX XXXXD  XXDXX
XXXXX XXXXX       XX  DX
XXXX  XXXXXXXXXXX  XX   
XXXXXXXXXXXXXXXXX  X   X
XXXXXXXXXXXXXXXXX     D 
XXXXXXXXXXXXXXXXXXD    X
XXXXXXXXXXXXXXXXX      X
XXXXXXXXXXXXXXXXX XX   X
 XXXXXXXXXXXXXXX DX  XXX
XXXXXXXXXXXXXXXX    XXXX
X XXXXXXXXXXXXXXX X XXXX
X  XXXXXXXXXXXXXX X  XXX
XXXXXXXXXXXXXXXXX XXXXXX
XXXXXXXXXXXXXXXXX XXXXXX
XXXXXXXXXXXXXXXX  XXXXXX
XXXXXXXXXXXXXXXXX DXXXXX
XXXXXXXXXXXXXXXX   XXXXX
XXXXXXXXXXXXXXXX XXXXXXX
XXXXXXXXXXXXXXXXXXXXXXXX
XXXXXXXXXXXXXXXXXXXXXXXX