XXXXXXXXXXXXXXXXXXXXXXX
XXXXXXXXXXXXXXXXXXXXXXX
XXXXXXXXXXXXXXXXXXXXXXX
XXX   XXXXXXXXXXXXXXXXX
XXX   XXXXXXXX  XXXXXXX
XXXX XX   XXXX  XXXXXXX
XXXX XX     XX  XXXXXXX
X               XXXXXXX
X            X  XXXXXXX
XX   X    X  X  XXXXXXX
XX     p  X  XX XXXXXXX
XX        X  XX XXXXXXX
XX   X    X  XX XXXXXXX
X p  X       XX XXXXXXX
X               XXXXXXX
X        p      XXXXXXX
X                    XX
X            XX X    XX
X              XXXXXXXX
X       XXXXXXXXXXXXXXX
XXXXX   XXXXXXXXXXXXXXX
XXXXXXXXXXXXXXXXXXXXXXX
XXXXXXXXXXXXXXXXXXXXXXX