XXXXXXXXXXXXXXXX
XX    XXXXXXXXXX
XX    XXXXXXXXXX
XX           XXX
XX    XX     XXX
XXXX  XXXX X XXX
XXXX  XXXXDXDXXX
XXXX  XXXX  pXXX
XXXX  X pX   XXX
X            XXX
X   X X  X   XXX
X         XXXXXX
X      X XXXXXXX
XXX    DXXXXXXXX
XXXXXXXXXXXXXXXX
XXXXXXXXXXXXXXXX