XXXXXXXXXXXXXXXXXXXXXXX
XX   XXXXXXXXXXXXXXXXXX
XX   XXXXXXXXXXXXXXXXXX
XX                  XXX
XX   XXXXXXXXXX      XX
XXX XX         p     XX
XX  XX       XX      XX
XX  XXXX XXX XXXXX  XXX
XX  XXXX XXX XXXXX  XXX
XX  XXXX XXX XXXXX  XXX
XXX XX    XX XXXXX  XXX
XXX XX  p XX XXXXX  XXX
XXX XX    X   XXXX  XXX
XXX           XXXX  XXX
XXXp p    X         XXX
XXXXXXXX XXXXX XXX  XXX
XXXXXXXX XXXXX XXX XXXX
XXXXXXXX XX      X XXXX
XXXXXXXXD         XXXXX
XXXXXXXXXXX      XXXXXX
XXXXXXXXXXXXXXXXXXXXXXX
XXXXXXXXXXXXXXXXXXXXXXX
XXXXXXXXXXXXXXXXXXXXXXX