XXXXXXXXXXXX
XXXXXXXXXXXX
XXXXXXXXXXXX
X  XXXXXXXXX
X  DXXXXXXXX
X  DXXXXXXXX
XX  XXXXXXXX
X    XX  XXX
X       pXXX
X   pXXXXXXX
XXXXXXXXXXXX
XXXXXXXXXXXX