      XX
XX  X XX
XX  X XX
X p p XX
Xp  p XX
XXXXXXXX
XXXXXXXX
XXXXXXXX