XXXXXXXXXXXXXXXXXXX
XXXXXXXXXXXXXXXXXXX
XXXXXXXXXXXX   pXXX
XXXXXXXXXXXX    XXX
XXXXXXXXXX      XXX
XXXXXXXXXX X    XXX
XXXXXXXXXX XX    XX
XXX              XX
XXX XXXXX  XX    XX
X     XXX  XXX  XXX
X      D       XXXX
XX  XXXXX  XXX XXXX
XX  XXXXXXXXXX XXXX
XX            XXXXX
XX  XX    XXXXXXXXX
XXX       XXXXXXXXX
XXXXXX    XXXXXXXXX
XXXXXXXXXXXXXXXXXXX
XXXXXXXXXXXXXXXXXXX