XXXXXXXXXXXXXXXXXXXXXX
XXXXXXXXXXXXXXXXXXXXXX
XXXXXXXXXXXXXXXXXXXXXX
XXXXXXXXXXXXXXXXXXXXXX
XXXXXXXXXXXXXXXXXXXXXX
XX   XXXXXXXXXXXXXXXXX
XX   XXXXXXXXXXXXXXXXX
XX                 XXX
XX      XXXXXXXXX  XXX
XX       XXXXXXXX  XXX
XXX                XXX
XXX       X   p X  XXX
XXX       X XXX X  XXX
XXX            XXXXXXX
XXX       X XXXXXXXXXX
XXXp      X XXXXXXXXXX
XX      XX   XXXXXXXXX
XX      XX   XXXXXXXXX
XX   XX      XXXXXXXXX
XX  XXXXXX  pXXXXXXXXX
XXXXXXXXXXXXXXXXXXXXXX
XXXXXXXXXXXXXXXXXXXXXX