XXXXXXXXXXX
X  XXXXXXXX
Xp      XXX
XXXXXXX XXX
XXXXXXX XXX
X  XXXX XXX
X  XXXp XXX
XX      XXX
XXXXXXXXXXX
XXXXXXXXXXX
XXXXXXXXXXX