XXXXXXXXXXXXXX
XXXXXXXXXXXXXX
XXXXXXXXXXXXXX
XXXXXXXXXXXXXX
XX  XX  XXXXXX
XX   X  XXXXXX
XXX  XX XXXXXX
XXX  XX X  XXX
X   D      XXX
X      XX   XX
XXX         XX
XXXXXXXXX   XX
XXXXXXXXXXXXXX
XXXXXXXXXXXXXX