XXXXXXXXXXXXXXXXXXXXXXX
X   XXXXXXXXXXXXXXXXXXX
X      XXXXXXXXXXXXXXXX
X   XX      XXXXXXXXXXX
XX XXX        D    XXXX
X   XX      XXXXXX XXXX
X   XX XX XXXXXXXX XXXX
X   XX XX XXXXXXXX XXXX
X   X  XX XXXXXXXX XXXX
X   X  XX XXXXXXXX XXXX
XX XX  X  XXXXXXXX XXXX
XX XX     XXXXXXXX XXXX
XX        X     X  XXXX
XX        X     X  XXXX
XX        X     X  XXXX
XX             p   XXXX
XX p       p    X  XXXX
XX        X    pX  XXXX
XX        XX XXXXXXXXXX
XX        X  XXXXXXXXXX
XXX    XX    XXXXXXXXXX
XXXXXXXXXXXXXXXXXXXXXXX
XXXXXXXXXXXXXXXXXXXXXXX