XXXXXXXXXXXX
XXXXX  XXXXX
XXXXX  XXXXX
XX   X XXXXX
XX   X XXXXX
Xp  XX XXXXX
X p XX XXXXX
X     DXXXXX
X     D pXXX
X        XXX
XXXXXXXXXXXX
XXXXXXXXXXXX