XXXXXXXXXXXXXXXXXXX
XXXXXXXXXXXXXXXXXXX
XXXXXXXXXXXXXXXXXXX
XXXXXXXXXXXXXXXXXXX
X     XXXXXXXXXXXXX
X        XXX   XXXX
XXX XXXX XXX   XXXX
XXX   D  D     XXXX
XX    XX XXX   XXXX
XX    XX XXXX XXXXX
XX               XX
XX         XX p  XX
XX         XX    XX
XXXX XXXXXXXXXXXXXX
XXXX XXXXXX     XXX
XXXX            XXX
XXXXXXXXXXX     XXX
XXXXXXXXXXXXXXXXXXX
XXXXXXXXXXXXXXXXXXX