XXXXXXXXXXXXXXXXXXXXXXXX
Xp XXXXXXXXXXXXXXXXXXXXX
X           XXXXXXXXXXXX
X  XXXXXXXX XXXXXXXXXXXX
XX XXXXXXXX    XXXXXXXXX
XX XX          XXXXXXXXX
X       XXX XDXXXXXXXXXX
X             XXXXXXXXXX
XX      X     XXXXXXXXXX
XX      X  p  XXXXXXXXXX
XX      X  p  XX    XXXX
XX   p  X     XX    XXXX
XX      X XXXXXX    XXXX
XX XX   X           XXXX
XX XX      XXXXX    XXXX
XXD           XX    XXXX
XX            XX  p XXXX
XX            XXXX XXXXX
XXX                XXXXX
XXX               XXXXXX
XXXX          XXXXXXXXXX
XXXXX         XXXXXXXXXX
XXXXXXXXXXXXXXXXXXXXXXXX
XXXXXXXXXXXXXXXXXXXXXXXX