XXXXXXXXXXXXXXXXXX
XXXXXXXXXXXXXXXXXX
X   XXXXXXXXXXXXXX
X     XXXXXXXXXXXX
X   X XXXXXXXXXXXX
XX     XXXXXXXXXXX
XX     XXX  XXXXXX
XX          XXXXXX
XX DX XXXXX XXXXXX
X     X  XX XXXXXX
X     X    DXXXXXX
X          XXXXXXX
X      X X XXXXXXX
X   p        XXXXX
X              XXX
X              XXX
XXXXXXXXXXXXXXXXXX
XXXXXXXXXXXXXXXXXX