 XXXXXXXXXXXXX
XXXXXXXX  XXXX
XXXX  X  XXXXX
XXXXX   XXXXXX
XXXXXXXXXXXXXX
XXXXXXXXXXXXXD
XXXXXXXXXXXpD 
XXXXXXXXXXX   
XXXXXXX X     
XXXXX        D
XXXX     XX   
XX   X  XXX   
    XXXXXXXXXX
XX XXXXXXXXXXX