XXXXXXXXXXXXXXXXXXX
XXXXX   XX XX  p XX
XXXX    XD XX    XX
X  XX   X XXXX    X
XX XX  XX XXXDD    
XXXX   XX XXXX     
XXXX   XX XXXXXpXXX
X      XX XXX   XXX
XXXX   XX XXX pXXXX
XX      X XXXXXXXXX
X  pX   X XXXXXXXXX
X    D  X XXXXXXXXX
XXXXXX XXDXXXXXXXXX
XXXX      XXXXXXXXX
XXXX    XXXXXXXXXXX
XXX     XXXXXXXXXXX
X   X   XXXXXXXXXXX
XXXXXXXXXXXXXXXXXXX
XXXXXXXXXXXXXXXXXXX