XXXXXXXXXXXXXXXXXXXXXXXX
XXXXX     XXXX  XXXXXXXX
 XXX  D   XXXX  XXXXXXXX
X                       
XX   XX p XXXXX  XXXXXXX
XXX   X X XXX    XXXXXXX
XXXX  X     D    XXXXXXX
XXXXX XXXX    XX XXXXXXX
XXXX   XX     XX  XXXXXX
XXD    X    X XXX  XXXXX
XXX   XXXX XX XXXX XXXXX
XXX XXXXXX X   XXX XXXXX
XXX  XXXXXD      XXXXXXX
XXX  XXXXXX  XXX XXXX   
XXX     XXXX  XX  XX    
XXXXXXXXXXXXX   X XX  XX
XXXXXXXXXXXXXXX X XXX XX
XXXXXXXXXXXXXXX XXXXXXXX
XXXXXXXXXXXXXXX XXXXXXXX
XXXXXXXXXXXXXXX     XXXX
X  XXXXXXXXXXXXXXXX   XX
XXXXXXXXXXXXXXXXXXXX  XX
XXXXXXXXXXXXXXXXXXXX DXX
XXXXXXXXXXXXXXXXXXXX XXX