XXXXXXXXXXXXXXXXXXX
XXXXXXXXXXXXXXXXXXX
XX  X  XXXXXXXXXXXX
XX  X  XXXXXXXXXXXX
XX  D  X  XXXXXXXXX
XX  X  X         XX
XXXXX p          XX
XXXXXXXXX XX     XX
XX  XXXXX XXXX  XXX
X   XXXXX XXXX  XXX
X       X XXXX  XXX
X         XXXX  XXX
XX     p  XXX    XX
XX     p  XXX    XX
XXX              XX
XXX p    XXXX    XX
XXX  XXXXXXXXXXXXXX
XXXXXXXXXXXXXXXXXXX
XXXXXXXXXXXXXXXXXXX