XXXXXXXXXXXXXXXXXXXXXXXX
XXXXX      XXXXXXXXXXXXX
X  pX      D  XXXXXXXXXX
X   XXXXDXXXX XXXXXXXXXX
X             XXXXXXXXXX
X   XXXX XXX  XXXXXXXXXX
X   XXXX XXX  XXXXXXXXXX
XXDXXXXX XXX DXXXXXXXXXX
X        XXX  XXXXXXXXXX
X        X      XXXXXXXX
X        X      XXXXXXXX
X            XXXXXXXXXXX
X   p    XXX       XXXXX
X        XXX  p    XXXXX
X        D         XXXXX
XX XX  X XXX       XXXXX
XX       XXX XXX XXXXXXX
XX            p      XXX
XX              X    XXX
XX    p       p    p XXX
XX              X    XXX
XXXp    XXX  XXXX    XXX
XXXXXXXXXXXXXXXXXXXXXXXX
XXXXXXXXXXXXXXXXXXXXXXXX