XXXXXXXXXX
XXXXXXXXXX
X  XXXXXXX
Xp  X  XXX
XX  X  XXX
XX     XXX
X   X  XXX
Xp     XXX
XXXXXXXXXX
XXXXXXXXXX