XXXXXXXXXXXXXXXXXXXX
XXXXXXXXXXXXXXXXXXXX
XXXXXXXXXXXXXXXXXXXX
X  XXXXXXXXXXXXXXXXX
X  XX    XXXXXXXXXXX
X  D     XXXXXXXXXXX
X  XX    XXXXXXXXXXX
X  XXDX XXX  XXXXXXX
XX          pXXXXXXX
XXXXX   XXXX XXXXXXX
XXXX    XXXXDXXXXXXX
XXXX      D XXXXXXXX
XXXX    XXXXXXXXXXXX
XXXX   XXXXXXXXXXXXX
XXXX  XXXXXXXXXXXXXX
XXXXXXXXXXXXXXXXXXXX
XXXXXXXXXXXXXXXXXXXX
XXXXXXXXXXXXXXXXXXXX
XXXXXXXXXXXXXXXXXXXX
XXXXXXXXXXXXXXXXXXXX