XXXXXXXXXXXXX
XXXXXXXXXXXXX
XXXXX   XXXXX
XXXXX   X  XX
XX  D     pXX
XX     XX  XX
X  p      XXX
X   p   XXXXX
X      pXXXXX
X       XXXXX
X   XXXXXXXXX
XXXXXXXXXXXXX
XXXXXXXXXXXXX