XXXXXXXXXX
XXXXXXXXXX
X  XXXXXXX
X    XXXXX
XX   XXXXX
XX      XX
X   pX  XX
X       XX
XXXXXXXXXX
XXXXXXXXXX