XXXXXXXXXXXXXXX
XXXXXXXXXXXXXXX
XXXXXXXXXXXXXXX
XXXXXXXXXXXXXXX
XXXXX  XXX  XXX
X  p   XXX  XXX
X   XX      XXX
XXXX    XX  XXX
XXXX       XXXX
XXXXXXp  XXXXXX
XXXXXX   XXXXXX
XXX    XXXXXXXX
XXX    XXXXXXXX
XXXXXXXXXXXXXXX
XXXXXXXXXXXXXXX