XXXXXXXXX
X  XXXXXX
X  XXXXXX
XXDXXXXXX
X   XXXXX
X      XX
X  XX  XX
XXXXXXXXX
XXXXXXXXX