XXXXXXXXXX
XXXXXXXXXX
XXXXXXXXXX
XXXXXXXXXX
XXX  Xp XX
XXX     XX
XXX  XXXXX
XXX  XXXXX
XXXXXXXXXX
XXXXXXXXXX