XXXXXXXXX
XXXXXXXXX
XXXXXXXXX
Xp XXXXXX
X    pXXX
X  X  XXX
X pXXXXXX
XXXXXXXXX
XXXXXXXXX