 XXXXXXXXXXXXXXX
XXXXXXXXXXXXXXXX
XXXXXXXXXXXXXXXX
XXXXXXXXXXXXXXXX
XXXXXXXXXXXXXXXX
XXXXXXXXXXXXXXXX
XXXXXXXXXXXXXXXX
XXXX   XXXXXX   
XXXX X          
XXXXXXXXXXX     
XXXXXXX  D     X
XXXXXXXXXXXXX   
XXX  XXXX       
XXXX    XXXXX   
XXXXXXX  pp  X  
XXXXXXXXXX   XX 