XXXXXXXXXXXXXXXXXXXXX
XXXXXXXXXXXXXXXXXXXXX
XXXXXXXXXXXXX     XXX
XXXXXXXXXXXXX     XXX
XXXXXXXXXXXXX p   XXX
XXXXXXXXXXXXX     XXX
XXXXXXXXXXXXX     XXX
X   XXXXXXXXXXXDXXXXX
X    XXXXXXX     XXXX
X    XXXXXXX     XXXX
X    D           XXXX
X p  XXXXXXX     XXXX
X   XXXXXXXX     XXXX
XXXXXXXXXXXXXX XXXXXX
XXXXXXXXXXXXXX XXXXXX
X         XXX   XXXXX
X               XXXXX
X         D   XXXXXXX
X       p XXXXXXXXXXX
XXXXXXXXXXXXXXXXXXXXX
XXXXXXXXXXXXXXXXXXXXX