XXX XDXXXX
XX  D  X  
XXX XX X  
XXXXXX X D
XXXXXX X X
XXXXXX XXX
XXXXXXXXXX
XXXXXXXXXX
XXXXXXXXXX
XXXXXXXXXX