XXXXXXXXXXXXXXXXXXXXXX
XXXXXXXXXXXXXXXXXXXXXX
X  XXXXXXXXXXXXXXXXXXX
X  XXXXXXXXXXXXXXXXXXX
X  XXXXXXXXXXXXXXXXXXX
X   XXXXXXXXXXXXXXXXXX
X     p  XXXXXXXXXXXXX
X             XXXXXXXX
XX                XXXX
XX       XX XXXXX XXXX
XX        X XXXXX XXXX
XX        X XXXXX XXXX
XX        X    XXDXXXX
XX      p      XX XXXX
XX         XX XXX XXXX
XX         XX    p  XX
XX         XXD      XX
XX           X      XX
XX  X      XXXXXXXXXXX
XXXXXXXXXXXXXXXXXXXXXX
XXXXXXXXXXXXXXXXXXXXXX
XXXXXXXXXXXXXXXXXXXXXX