XXXXXXXXXXXXXXXXXXXXXXX
XXXXXXXXXXXXXXXXXXXXXXX
XXXXXXXXXXXXXXXXX  pXXX
XXXXXXXXXXXXXXXXXX XXXX
    XXXXXXXXXXXXXX  XXX
X     XXXXXXXXXX    XXX
XX XX XXXXXXXXXXX    XX
X  XX  XXXXXXXXXX  X  X
X XXXX XXXXXXXXXX   X  
X XXXX   XXXXX      XX 
XXXXX   XXXXX   DXXXXX 
 XXXX   XXXXX    XXXXXX
XXX XX  XXXXXX   X XXXX
XXX XX  XXXXXXXX  D XXX
XXX XX  XXXXXXXXX     X
XXX     XXXXXXXXX  XX X
XX   XXXXXXXXXXX    X  
X   XXXXXXXXX  X       
XX  XXXXXXXXX  XX  X  X
X  XXXXXXXXXX   X XX  X
XXXXXXXXXXXX  XXX     X
XXXXXXXXXXXX    X   X X
XXXXXXXXXXXXX      XX X