XXXXXXXXXXXXX
XXXXXXXXXXXXX
XXXXXXXXX    
XXXX DX      
XXXXX   X    
XXXXX     XX 
XXX   XXXXXXX
XXX XXXXXXXXX
XXX XXXX     
XXXXXXXXXXX  
XXXXXX XXXXX 
XXXXXX XXXXX 
XXXXXD  XXXXX