XXXXXXXXXXXXXXXXXXXXXX
XXXXXXXXXXXXXXXXXXXXXX
XXXXXXXXXXXXXXXXXXXXXX
XXXXXXX   XXXXXXXXXXXX
XX    X   X    XXXXXXX
XX             XXXXXXX
XX    X        XXXXXXX
XXXX XX   X    XXXXXXX
XXXX XX XXX XXXXXXXXXX
XXXX XX XXX XXXXXXXXXX
XXXX XX XXX XXXXXXXXXX
XXXX XX XXX XXXXXXXXXX
XXXX XX XXX XXXXXXXXXX
XXXX   p      XXX   XX
XXXX                XX
XXXX XXXX  XXXXXXXXXXX
XXXX XXXX  XXXXXXXXXXX
XXXX       XXXXXXXXXXX
XXXXXXXXX  XXXXXXXXXXX
XXXXXXXXX  XXXXXXXXXXX
XXXXXXXXXXXXXXXXXXXXXX
XXXXXXXXXXXXXXXXXXXXXX