XXXXXXXXXXX
XXXXXXX  XX
XXXXX   pXX
X  XX XX XX
X        XX
XX       XX
X  X XXXXXX
X    XXXXXX
XX   XXXXXX
XXXXXXXXXXX
XXXXXXXXXXX