XXXXXXXXXXXXXXXXXXX
X    XXXXXXXXXXXXXX
X           XXXXXXX
X    XXXXXX XXXXXXX
XXX XXXXXXX XXXXXXX
XXX XXXXXXX XXXXXXX
XXX X     X XXXXXXX
XXX       X XXXXXXX
XX   XX XXX XXXXXXX
XX          XXX  XX
XX               XX
XX     XX     XXXXX
XX  p   X     XXXXX
XX      X     XXXXX
XX  XXXXX   p XXXXX
X     XXXXXXXXXXXXX
X     XXXXXXXXXXXXX
XXXXXXXXXXXXXXXXXXX
XXXXXXXXXXXXXXXXXXX