XXXXXXXXXXXXX
X  XXXXXXXXXX
X       XXXXX
X  XXX  XXXXX
X  XXX  XXXXX
X  XXX  XXXXX
X pXXXX XXXXX
XX XXX   XXXX
XXD      XXXX
X        XXXX
X  p  XXXXXXX
XXXXXXXXXXXXX
XXXXXXXXXXXXX