XXXXXXXXXXXXXXXXXXXXXX
XXXXXXXXXXXXXXXXXXXXXX
XXXXXXX      X  XXXXXX
XXXXXXX      X  XXXXXX
X            X  XXXXXX
X               XXXXXX
X         XXXX  XXXXXX
X    XXXXXXXXX  XXXXXX
X    XXXXXXXXXX XXXXXX
XXX XXXXXXXXXXX XXXXXX
X    X     pXXX p XXXX
X    X      XXX   XXXX
X             XX  XXXX
X    X        XXX XXXX
X             XXX XXXX
XXXXX      X     XXXXX
XXXXXXXXXXXX  XXXXXXXX
XXXXXXXXXXXX  XXXXXXXX
XXXXXXXXXXXXXXXXXXXXXX
XXXXXXXXXXXXXXXXXXXXXX
XXXXXXXXXXXXXXXXXXXXXX
XXXXXXXXXXXXXXXXXXXXXX