XXXXXXXXXXX
XX  XXXXXXX
XX       XX
XXX XXXX XX
XXX XXXX XX
X    XXXDXX
X    DX  XX
XXXD     XX
XXX   XXXXX
XXXXXXXXXXX
XXXXXXXXXXX