XXXXXXXXXXXXXXXXXXXXXX
XXXXXXXXXXXXXXXXXXXXXX
XXXXXXXXXXXXXXXXXXXXXX
XXXXXXXXXXXXXXXXXXXXXX
X  XXXXXXXXXXXXXXXXXXX
X  D     D DXXXXXXXXXX
XXDXX   XXX XXXXXXXXXX
XX XX   XXX XXXXXXXXXX
XX XX   XXX XXXXXXXXXX
XX XXX  XXX XXXXXXXXXX
X       XXX     XXXXXX
X               XXXXXX
X         X X XXXXXXXX
X    p    XDXDXXXXXXXX
X           X XXXXXXXX
Xp           D   XXXXX
X             XX XXXXX
X     p            XXX
X                  XXX
XXX  XX     X      XXX
XXXXXXXXXXXXXXXXXXXXXX
XXXXXXXXXXXXXXXXXXXXXX