XXXXXXXXXXXXX
XXXXXXXXXXXXX
XXXXXXXX  XXX
XX  XXXX  XXX
XX  XXXXX XXX
XX  XXXXX XXX
X pD   XX  XX
X   p      XX
XX p       XX
XX        XXX
XXXXXXXXXXXXX
XXXXXXXXXXXXX
XXXXXXXXXXXXX