XXXXXXXXXXXX
XXXXXXXXXXXX
XX  XXXXXXXX
XX pXXXXXXXX
X   XXXXXXXX
X   XXXXXXXX
X    XX  XXX
X        XXX
X    XX  XXX
XXXXXXXXXXXX
XXXXXXXXXXXX
XXXXXXXXXXXX