XXXXXXXX
XXXXXXXX
XXX  XXX
XXX  XXX
X    XXX
X   XXXX
XXXXXXXX
XXXXXXXX