XXXXXXXXXXXXXXXXXXXXXX
X   XXXXXXXXXXXXXXXXXX
X                D  XX
X   XXXX  XXXXXXXXX XX
XXXXXXXX    XXXXXXX XX
XXXXXXXX  X XXXXXXX XX
XXXXXXXXX X XXXXXXX XX
XXXXXXXXX X XXX  XX XX
XX        D      XX XX
XX      X X XXXX XX XX
XX      X XDXXXX XX XX
XX      X X XXXX XX XX
XX       XX XXXX XX XX
XX        X XXXX XX XX
XX        X XXXX XX XX
XXXXXXXXX     XX XX XX
XXXXXXXXX     XX X  XX
XXXXXXXXX     XX    XX
XXXXXXXXX    XXXXXXXXX
XXXXXXXXXXXXXXXXXXXXXX
XXXXXXXXXXXXXXXXXXXXXX
XXXXXXXXXXXXXXXXXXXXXX