XXXXXXXXXXXXXXXXXXXXXXX
XXXXXXXXX XXXXXXXXXXXXX
XXXXXXXX   XXXXXXXXXXXX
X   XXXX X  XXXXXXXXXXX
XXXXXXXX  X XX   XXXXXX
XXXXXXXXX   XXX  XXXXXX
XX XXXX   DXXXXD XXXXXX
XX XXXX   XXXXX pXXXXXX
XX   XX     XXXX  XXXXX
XX     XX    XXX  XXXXX
XX  XXpXX X XXXX XXXXXX
X               DXXXXXX
XX        X   XXXXXXXXX
XXX   XX    XXXXXXXXXXX
XXX   XXX       XXXXXXX
XXX  XXX   XX X XXXXXXX
XX p XXXX  XX   XXXXXXX
XX   XXX   XX   XXXXXXX
X    XXXX   X  XXXXXXXX
X      X  X X  XXXXXXXX
X      X       XXXXXXXX
X X  XXXXp X  XXXXXXXXX
XXX   DX   X  XXXXXXXXX