XXXXXXXXXXXXXXXXXXXXXX
X p  XXXXXXXXXXXXXXXXX
X     XXXXXXXXXXXXXXXX
X     XXXXXXXXXXXXXXXX
XXX X XXXXXXXXXXXXXXXX
XX    XXX    XXXXXXXXX
XX    XXX    XXXXXXXXX
XX            XXXXXXXX
XX    XXX  p      XXXX
XX    XXX p   XXX XXXX
XXX   XXX     XXX XXXX
XXX   X   X X       XX
XXX   X p XDX       XX
XX        X X       XX
XX                XXXX
XX             X  XXXX
XX        X    X  XXXX
XX                XXXX
XX             X  XXXX
XXXXXXXXXXXX   X  XXXX
XXXXXXXXXXXXXXXXXXXXXX
XXXXXXXXXXXXXXXXXXXXXX