XXXXXXX XXXXXXXXXXXX
XXXXXXXXXXXXXXXXXXXX
 XXXXXXXXXXXXXXXXXXX
XXXXXXXXXXXXXXXXX  X
XXXXXXXXXXX XXXXXX X
XXXXXXXXXXX  XXXXX X
XXXXXXXXXXXX  XXXX X
XXXXXXXXXXXXX XX   X
XX XXXXXXXXX  X  XXX
XX XXXXXXXXX XX  XXX
X  XXXXXXXX  XX  XXX
XX  XXXXXXX   XX   X
X   XXXXXXX   XX  XX
XXX p XXXXX    XX XX
XXX XXXXXXX X  XX   
XXX XXXXXX     XXXX 
XXX XXXXXXX    XXXX 
Xp  XXXX         XX 
X XXXXXXX X pX D    
XXXXXXXXX   XXX     