XXXXXXXXXXXX
XXXXXXXX  XX
XXXXX  X  XX
X   X    XXX
X      XXXXX
XX XXX XXXXX
XX XXX XXXXX
XX     XXXXX
XX     XXXXX
XXXXX  XXXXX
XXXXXXXXXXXX
XXXXXXXXXXXX