XXXXXXXXXXX XXXXX
XX   DD XXXXD XXX
XX    X XXXXX XXX
X     X XXXXX  pX
X       XXXXXXX  
XXX     XXXXXXX  
XXX X   XXXXXX  X
XXX     XXXXX  DX
XXX XX XXXXXXXXXX
XXX  X    XXXXXXX
XXX  XXX  XXXXXXX
XXX XXXX XXXXXXXX
XX  XXXX XXXXXXXX
XX  XXXXXXXXXXXXX
XXXXXXXXXXXXXXXXX
XXXXXXXXXXXXXXXXX
XXXXXXXXXXXXXXXXX