XXXXXXXXXXXXXXXXXXXXX
XXXXXXXXXXXXXXXXXXXXX
XX  XXXXXXXXXXXXXXXXX
XX      D   XXXXXXXXX
XXX XXXXXXX XXXXXXXXX
X    XXXXXX XXX  XXXX
X        XX XXX  XXXX
X   XXXX XX XXX  XXXX
X     D       D  XXXX
X     XX X p    XXXXX
X    pp  D     pXXXXX
X               XXXXX
XX    Xp      XXXXXXX
XX    Xp      XXXXXXX
XX         p  XXXXXXX
XX  D         XXXXXXX
XX           pXXXXXXX
XXX p         XXXXXXX
XXX     XXXXXXXXXXXXX
XXXXXXXXXXXXXXXXXXXXX
XXXXXXXXXXXXXXXXXXXXX