XXXX XXXX
X XX   XX
X  XX XXX
 X p  XXX
XXXXXXXXX
XXXXXXXXX
XXXXXXXXX
XXXXXXXXX
XXXXXXXXX