XXXXXXXXXXXXXXXXXX
XXXXXXXXXXXXXXXXXX
XX    XXXXXXXXXXXX
XX    XXXXXXXXXXXX
XX X XXXXXXXXXXXXX
XX X XXXXXXXXXXXXX
X  X XXXXXXXXXXXXX
X    XXXXXXXXXXXXX
XXXX XXXXXXXXXXXXX
X    XXXXXXXXXXXXX
X            XXXXX
X     pXXXXX XXXXX
XX      XX     XXX
XX      XX     XXX
XX      XX     XXX
XXXX  p XX     XXX
XXXXXXXXXXXXXXXXXX
XXXXXXXXXXXXXXXXXX