XXXXXXXXXXXXXXXXXXXXXXXX
XXXXXXXXXXXXXXXXXXXXXXXX
XXXXXXXXXXXXXXXXXXXXXXXX
XXXXXXXXXXXXXXXXXXXXXXXX
XX     XXXXXXXXXXXXXXXXX
XX    p           XXXXXX
XXXX XXXXXXXX pXX XXXXXX
XXXX      XXX  XX XXXXXX
XXXX      XXXX XX XXXXXX
XXX       XXXX XX XXXXXX
XX        XXXX XX XXXXXX
XX           X XX XXXXXX
XX        X    XX XXXXXX
XX       XX         XXXX
XX  p               XXXX
XXXXX  X  X   X     XXXX
XXXXX  X  X   XXXXXXXXXX
XXXXX        XXXXXXXXXXX
XXX      p   XXXXXXXXXXX
XXX          XXXXXXXXXXX
XXX          XXXXXXXXXXX
XXXXXXXXXXXXXXXXXXXXXXXX
XXXXXXXXXXXXXXXXXXXXXXXX
XXXXXXXXXXXXXXXXXXXXXXXX