XXXXXXXXXXXXXXXXXXXXX
XXXXXXXXXXXXXXXXXXXXX
XXXXXXXXXXXXXXXXXXXXX
XXXXXXXXXXXXXXXXXXXXX
X    X   XXXXXXXXXXXX
X    X   XXXXXXXXXXXX
X        XXXXXXXXXXXX
X p  X   XXX    XXXXX
X    XX XXXX    XXXXX
X    XX XXXX   pXXXXX
X     DD         XXXX
X    XX    X     XXXX
X          X   X XXXX
X              X XXXX
X            X X XXXX
X       X XXXX X XXXX
X             XX XXXX
X      XX XXXX     XX
XX     XX          XX
XXXXXXXXXXXXXXXXXXXXX
XXXXXXXXXXXXXXXXXXXXX