XXXXXXXXXXX
XXXXXXXXXXX
XXXXXXXXXXX
XXXXXXXXXXX
XXXX  XXXXX
X  X  XXXXX
X     XXXXX
X     XXXXX
XX  XXXXXXX
XXXXXXXXXXX
XXXXXXXXXXX