XXXXXXXXXXXXXX
X   XXXXXXXXXX
X    XXXXXXXXX
X    XXXXXXXXX
XX X XXXXXXXXX
XX X XXXXXXXXX
XX    XXXXXXXX
X     XXXXXXXX
X p    XX  XXX
X        p XXX
X      XX  XXX
X p   XXXXXXXX
XXXXXXXXXXXXXX
XXXXXXXXXXXXXX