XXXXXXXXXXXXXXXXXXXXXXX
X     XXXXXXXXXXXXXXXXX
X     XXXXXXXXXXXXXXXXX
Xp           XXXXXXXXXX
X     XXXXXX XXXXXXXXXX
X     XXXXXX XXXXXXXXXX
XX     XXXXX XXXXXXXXXX
XX     XXXXX XXXXXXXXXX
XX     XXXXX XXXXXXXXXX
XXX   XXXXXX XXXXXXXXXX
X        XXX XXXXXXXXXX
X             XXXXXXXXX
X             XXXXXXXXX
X         XX XXXXXXXXXX
XX            XXXXXXXXX
X             XXXXXXXXX
X                  XXXX
X            XXXXX XXXX
X            XXXX   XXX
X         D  XXXX   XXX
X    XX  XXXXXXXX   XXX
XXXXXXXXXXXXXXXXXXXXXXX
XXXXXXXXXXXXXXXXXXXXXXX