XXXXXXXXXXXXXXXXX
XXXXXXXXXXXXXXXXX
XXXXXXXXXXXXXXXXX
XXXXXXXXXXXXXXXXX
XXXXXXXXXX    XXX
XXXXXXXXXX    XXX
XXXX          XXX
XXXX   XXX    XXX
XXX    XXXXX XXXX
XXX     XXXX XXXX
XX      XXXXDXXXX
XX      XXXX XXXX
XX      XXXX XXXX
XX     XXXXX XXXX
XX          XXXXX
XXXXXXXXXXXXXXXXX
XXXXXXXXXXXXXXXXX