XXXXXXXXXXXX
XXXX   XXXXX
XXXXp   XXXX
XXXXX X XXXX
X  X pX XXXX
X     X XXXX
Xp    X XXXX
X   XDX XXXX
X p     XXXX
X       XXXX
XXXXXXXXXXXX
XXXXXXXXXXXX