XXXXXXXXXXXX
XXXXX  XXXXX
XXXXX  XXXXX
XXXXX  XXXXX
XX  XX XXXXX
XX p     XXX
XX       XXX
X   XX   XXX
X     DXXXXX
X  XXXXXXXXX
XXXXXXXXXXXX
XXXXXXXXXXXX