XXXXXXXXXXX
XXXXXXXXXXX
XXXXXXXXXXX
XX  XXXXXXX
XX       XX
XX       XX
XX  XXX  XX
XX       XX
XX  XXXXXXX
XXXXXXXXXXX
XXXXXXXXXXX