XXXXXXXXXXXXXXXXXXXXX
XXXXXXXXXXXXXXXXXXXXX
XXXXXXXXXXXXXXXXXXXXX
XXX    XXXXXXXXXXXXXX
XXX           XXXXXXX
XXXXX XXXXXXX XXXXXXX
XXX   XXXXXXX XXXXXXX
XX      XXXXX XXXXXXX
XX            XXXXXXX
XX       XXX      XXX
XXX               XXX
X         XXX X XXXXX
X              XXXXXX
X         XXX XXXXXXX
X         X    XXXXXX
X              XXXXXX
X               XXXXX
XX              XXXXX
XXXXXXXXXX      XXXXX
XXXXXXXXXXXXXXXXXXXXX
XXXXXXXXXXXXXXXXXXXXX