XXXXXXXXXX
XXXXXXXXXX
XXXXXXXXXX
XXXXXXXXXX
X  XXX  XX
X       XX
X     DXXX
X  XXXXXXX
XXXXXXXXXX
XXXXXXXXXX