XXXXXXXXXXXXXXXXXXX
XXXXXXXXXXXXXXXXXXX
XX     XXXXXXXXXXXX
XX     XXXXXXXXXXXX
XX     XXXXXXXXXXXX
XX     XXXXXXXXXXXX
XXX  XXXXX  XXXXXXX
XX          XXXXXXX
XX          XXXXXXX
XX    X        XXXX
XXX    p XXXXX XXXX
XX       XXXXX XXXX
X        XXXXX XXXX
X       XXXXX  XXXX
X       XXXXX  XXXX
X  p           XXXX
XXXXXX   XXXX  XXXX
XXXXXXXXXXXXXXXXXXX
XXXXXXXXXXXXXXXXXXX