XXXXXXXXXXXXXX
XXXXXXXXXXXXXX
XXXXXXXXXXXXXX
XXXXXXXXXXXXXX
XXXXXXXXXXXXXX
XX   XXXXXXXXX
XX         XXX
XX   XXX   XXX
X  p XX   XXXX
X    DD   XXXX
X   XXXXXXXXXX
X   XXXXXXXXXX
XXXXXXXXXXXXXX
XXXXXXXXXXXXXX