XXXXXXXXXXXXXXXXXXXXXXXX
XXXXXXXXXXXXXXXXXXXXXXXX
XXXXXXXXXXXXXXXXXXXXXXXX
XXXXXXXXXXXXXXXXXXXXXXXX
XXXXXXXXXXXXXXXXXXXXXXXX
XX     XXXXXXXXXXXXXXXXX
XX                  XXXX
XX     XXXX     X     XX
XXXX XXXXXX     X     XX
XXXX XXXXXXp    X     XX
XXXX    XXX           XX
XXXX    XXX     X     XX
XXXX    XXX     X     XX
XXXXX   XXX     X     XX
XXX  X XXXX    XXXXXXXXX
XXX  X XXXX   pXXXXXXXXX
XXX            XXXXXXXXX
XXX            XXXXXXXXX
XXX         XXXXXXXXXXXX
XXX         XXXXXXXXXXXX
XXX    p    XXXXXXXXXXXX
XXXXX       XXXXXXXXXXXX
XXXXXXXXXXXXXXXXXXXXXXXX
XXXXXXXXXXXXXXXXXXXXXXXX