XXXXXXXXXXXXXXX
XXXXXXXXXXXXXXX
XXXXXXXXXXXXXXX
XXXXXXXX    XXX
XXX         XXX
XXX  p XXX XXXX
XXX    XXX XXXX
XXX    X     XX
X            XX
X            XX
XX     XX X  XX
XX p   D XXXXXX
XX   XXXXXXXXXX
XXXXXXXXXXXXXXX
XXXXXXXXXXXXXXX