XXXXXXXXXXXXX
XXXXXX   XXXX
XXXXXX   XXXX
XX   XX XXXXX
XX        XXX
XX        XXX
XXX XXX   XXX
XXX XXX XXXXX
XXX  p  XXXXX
X       XXXXX
X      XXXXXX
XXXXXXXXXXXXX
XXXXXXXXXXXXX