XXXXXXXXXXXXXX
XXX   XXXXXXXX
XX    XXXXXXXX
XXp  XXXXXXXXX
XX   XXXXXXXXX
XX X XXXXXXXXX
X p   XXXXXXXX
X        XXXXX
X    XX   XXXX
X  p      XXXX
X     X   XXXX
X     XXXXXXXX
XXXXXXXXXXXXXX
XXXXXXXXXXXXXX