XXXXXXXXDX XXXX
XXXX    XX    X
XXXXXX  XXXXXXX
XXXXXXXXXXXXXXX
  XXXXXXXXXX   
X  XXXXXXXXXXXX
XX  XXXXXXXXXXX
XXX XXXXXXXXXXX
 XX   XXXXXXXXX
XXXXXDXXXX     
XXXXX      X XX
XXXXXXXXXXXXXXX
XXXXXXXXXXXXXXX
XXXXXXXXXXXXXXX
XXXXXXXXX XXXXX