XXXXXXXXXX
XX  XXXXXX
XX     XXX
XXX  X XXX
XXX  X XXX
X    X XXX
X   X  XXX
X   X  XXX
XXXXXXXXXX
XXXXXXXXXX