    DXXX
XXXX XXX
XXXXDXXX
XXX  XXX
XXX  XXX
XXXXXXXX
XXXXXXXX
XXXXXXXX