XXXXXXXXXXXXXXXX
XXXXXXXXXXXXXXXX
XXXX    XXXXXXXX
XXXX    XXXXXXXX
XXXXXX XXXXXXXXX
X    X XXXXXXXXX
X   p  XXXXXXXXX
XXX    D   XXXXX
XXX    XXX XXXXX
XXX    XXX XXXXX
X     DXX   XXXX
X           XXXX
X     XXX   XXXX
X p XXXXXXXXXXXX
XXXXXXXXXXXXXXXX
XXXXXXXXXXXXXXXX