XXXXXXXXXXXXXXXXXXXX X
X pXXXXX      XXX   XX
X XXXXXX       XX   XX
X XXXXX   X XXXXX   XX
X  XXX   XX   XXX   XX
XX XXX   XX  X       X
XX XX  DXXD     XXX   
XX XX    XX XX  XXX X 
XXXXX  DXXX    XXXX X 
XXXXXX  XXXX   XXX   X
XXXX    XXXXX  XXXXX  
XXXX XX XXX    XXXXXX 
XXXX XX  X  XX  XXXXXD
XXXX XXXXXXXXXX XXXXX 
XXXX   XXXXXXXX  XXXX 
XXXX   XXXXXXXX  XXXX 
XXXXXX   XXXXXXX XXXX 
XXXXXXXXXXXXXXXX XXXX 
XXXXXXXXXXXXXXX  XX   
XXXXXXXXXXXXXX  X   XX
XXXXXXXXXXXXXX    XXXX
XXXXXXXXXXXXXXXXXXXXXX