XXXXXXXXXXX
XXXXXXXXXXX
XXXXXXXXXXX
X  XXXXXXXX
X     XXXXX
XX X  XXXXX
X    XXXXXX
X       XXX
X       XXX
XXXXXXXXXXX
XXXXXXXXXXX