XXXXXXXXXXXXXXXXXX
XXXXXXXXXXXXXXXXXX
XXXXXXXXXXXXXXXXXX
XXX  XXXXXXXXXXXXX
XXX  XXXXXXXXXXXXX
XXX       XXXXXXXX
XXX  XX    XXXXXXX
X  X XX    XXXXXXX
X  X       XXXXXXX
X     X    XXXXXXX
X             XXXX
X          XX XXXX
X             XXXX
X             XXXX
X           XXXXXX
XXXXX       XXXXXX
XXXXXXXXXXXXXXXXXX
XXXXXXXXXXXXXXXXXX