XXXXXXXXXXXXXXXX
XXXXXXXXXXXXXXXX
XXXXXXXXXXXXXXXX
X    XXXXXXXXXXX
X          XXXXX
XXX    XXX XXXXX
XX    XXXX XXXXX
XX    X    XXXXX
XX    X    XXXXX
XX  X XXX  XXXXX
X   X XXX   XXXX
X  XX       XXXX
X  XXXXXX   XXXX
XXXXXXXXX   XXXX
XXXXXXXXXXXXXXXX
XXXXXXXXXXXXXXXX