XXXXXXXXX
XX   X   
XXXX   XX
XXXXX   X
XXXXX  XX
XXXXX   X
XXXXX X X
XXXXX X X
XXXXXXXXX