XXXXXXXXXXXXXXXXX
XXXXXXXXXXXXXXXXX
XXXXXXXXXXX   XXX
XX pD         XXX
XX  XXXXXXX   XXX
XX       XXXDXXXX
XX  X      D XXXX
XXXXX    XXX XXXX
XXXXX    XXX XXXX
XXX      X    XXX
XXX      X    XXX
XXXX     X    XXX
XXXX    XX p  XXX
XXX  XX    XXXXXX
XXX        XXXXXX
XXXXXXXXXXXXXXXXX
XXXXXXXXXXXXXXXXX