XXXXXXXXXXXXX XXXXXXXX
XXXXX   X  XXXp XX XXX
XXX    XX pXXX     XXX
XXXpXX     XXXX   XXXX
 X p                  
XX   XXX  pXXX   XXXXX
XX   XXXX    X    XXXX
XXX   XXXX   XX X XXXX
XXXX  XXXXX   X X XXXX
XXXX    XXXX    X XXXX
XXXX    XXXX   XX XXXX
XXXXX p XXXX        XX
XXXXXX  XXXX X   XX  X
XXXXXX DXX p  DX XX XX
XXXXX        XXX XXDXX
XXX   XXX    XXp      
XXX  XXXX     XX pXXXX
XXX  DXXX  XX XX   XXX
XXXXX X    XXXXXXX XXX
XXXXX XXXXXXXXXXXX XXX
XXXXX  XXXXXXXXXXXDXXX
XXXXXXXXXXXXXXXXXX XXX