XXXXXXXXXXXXXX
XXXXXXXXX   XX
XXXX        XX
XXX   XXXX XXX
XXX   XXXX XXX
XXX   XXXX XXX
X    XXXXX XXX
X      D   XXX
X          XXX
XX   p     XXX
XX         XXX
XX    XXX  XXX
XXXXXXXXXXXXXX
XXXXXXXXXXXXXX