XXXXXXXXXXXXXXXXX
XXXX  XXXXXXXXXXX
XXXX        XXXXX
XXXXX XXXXX XXXXX
XXXXX XXXXX XXXXX
XXXXX XXXXX XXXXX
XXXX    XXX XXXXX
X       X  p XXXX
X p    XX    XXXX
Xp           XXXX
X       X    XXXX
X       XXXX XXXX
X  X     X    XXX
XX      p     XXX
XXXX  XXXX    XXX
XXXXXXXXXXXXXXXXX
XXXXXXXXXXXXXXXXX