XXXXXXXXXXXXXXXXXXXX
XXXXX X XXX XXXXXXX 
XXXXX X XXX XXXXX   
XXXXX X    DX XXX XX
XXXXXXX  XX       XX
XXXXXXXXXXXXXX  XXXX
XXXXXXXXXXXXXX     X
XXXXXXXXXX  p    X  
XXXXXXX      XX     
XXXXXX  XX X XX X  X
XXXX     X X    XXXX
XXXX XXXp  X   X X  
XXXXXXXXXXXXXXX  X  
XXXXXXXXXX         X
XXXXX   p  XX   XD X
XXXXXXXXXXXX  XXXX  
XXXXXXXXXXX  XXXX   
XXXXXXXXX X XXXXXp  
XXXXXX       XXX  X 
XXXXXXX  XX      XXX