XXXXXXXXXXXXXXXXXXXXXXXX
XXXX   p XXXXXXXXXXXXXXX
XXXX     XXXXXXXXXXXXXXX
XXXX     XXXXXXXXXXXXXXX
XXXXX  XXXXXXXXXXXXXXXXX
XXXXX  XXXXXXXXXXXXXXXXX
XXXXX  XXXXXXXXXXXXXXXXX
X   X  XXXXXX  XXXXXXXXX
X      XXXXXX  XXXXXXXXX
X p    X       XXXXXXXXX
X           Xp XXXXXXXXX
X                XXXXXXX
XX  p           pXXXXXXX
XX               XXXXXXX
XX     X         XXXXXXX
XX   p           XXXXXXX
XX              DXXXXXXX
XX                XXXXXX
XX              p X   XX
XX                D   XX
XXXXXXXXXXX           XX
XXXXXXXXXXXXXXXXXXX   XX
XXXXXXXXXXXXXXXXXXXXXXXX
XXXXXXXXXXXXXXXXXXXXXXXX