XXXXXXXXXXXXXXXXXXX
XXXXXXXXXXXXXXXXXXX
XXXXXXXXXXXXXXXXXXX
XX    XXXXXXXXXXXXX
XX     XXXXXXXXXXXX
XXX     XXXXXXXXXXX
X       XX  XXXXXXX
X           XXXXXXX
XXX      XX XXXXXXX
XXX      XX XXXXXXX
XX p   X  p XXXXXXX
XX     X   XXXXXXXX
XX         XX   XXX
XX     X XXXX   XXX
XXX   X  XXXX   XXX
XXX             XXX
XXX   XXXXXXXXXXXXX
XXXXXXXXXXXXXXXXXXX
XXXXXXXXXXXXXXXXXXX