XXXXXXXXXXXXXXXXXXXXXXX
XXXXXXXXXXXXXXXXXXXXXXX
XXXXXXXXXXXXXXXXXXXXXXX
XXXXXXXXXXXXXXXXXXXXXXX
XXXXXXXXXXXXXXXXXXXXXXX
XXXXXXXXXXXXXXXX     XX
XXXXXXXXXXXXXXXX     XX
XX    XXXXXXXXXX     XX
XX                   XX
XX        X XXXXp    XX
XXXX      X XXXX     XX
XXX       X XXXX    XXX
XXX      XX XXXX    XXX
XX                  XXX
XX                  XXX
XX             X    XXX
XX        p    XXX XXXX
XXX            XXX XXXX
XXX  p              XXX
XXX     X           XXX
XXX    XXXXXXXXXXXXXXXX
XXXXXXXXXXXXXXXXXXXXXXX
XXXXXXXXXXXXXXXXXXXXXXX