XXXXXXXXXXXXXXXXX
XXXXXXXXXXXXXXXXX
XXXX   XXXXXXXXXX
XXXX   XXXXXXXXXX
XXXX     XXXXXXXX
XXXX   X XXXXXXXX
XXXXX XX XXXXXXXX
XXXXX XX XX  XXXX
XXXXX XX XX  XXXX
XXXXXDXX XX  XXXX
XXXXX XX XX  XXXX
XXXXX      XDXXXX
XXXX       X XXXX
XXXX        XXXXX
XXXX      XXXXXXX
XXXXXXXXXXXXXXXXX
XXXXXXXXXXXXXXXXX