XXXXXXXXXXXX
XXXXXXXXXXXX
XXXX   XXXXX
XXXX      XX
X     XX pXX
X         XX
XX    DXXXXX
XX     XXXXX
XX     XXXXX
XXXp  XXXXXX
XXXXXXXXXXXX
XXXXXXXXXXXX