XXXXXXXXXXXXXXXXXX
XXXXXXXXXXXXXXXXXX
XXXXXXXXXXXXXXXXXX
X    XXXXXXXXXXXXX
X         XXXXXXXX
X      XX XXXXXXXX
X   p  XX      XXX
XX     XX     pXXX
XX  X          XXX
X  p           XXX
X         XX XXXXX
X             XXXX
XX            XXXX
XX            XXXX
XX        pXXXXXXX
XX     XXXXXXXXXXX
XXXXXXXXXXXXXXXXXX
XXXXXXXXXXXXXXXXXX