XXXXXXXX XXXXXXXXXX
XX  XX XXXXXX   X X
XX  XX XXXXX    XXX
XX XXXXXXXXX X  XXX
XX  XXXXXXXX    XXX
XXX XXXXXXXX  pXXXX
XX  XXXXXXXXp  XXXX
XXX XXXXXXX    XXXX
XDX XXXXXXX     XX 
X X XXXXXXX   X XXX
XXX  XXXXXX   X  XX
XXXX  XXXXX   Xp  X
XXX   XXXX    XX XX
XXX  XXXXX X XXXXXX
XXXX XXXXX   XXXXXX
XXX  XXXX   p  XXXX
XXX XXXXX  X XXXXXX
XXX XXXXXX XXXXXXXX
XXXXXXXXXXXXXXXXXXX