XXXXXXXXXXXXXXXXXXXXX
XXXXXXXXXXXXXXXXXXXXX
XXXXXXXXXXXXXXXXXXXXX
XXXXXXXXXXXXXXXXXXXXX
X    XXXXXXXXXXXXXXXX
X       XXXXXXXXXXXXX
X p   p XXXXXXXX   XX
XX                 XX
XX     X XXXXXXX   XX
X          XXXXXX XXX
X          XXXXXX XXX
X          XXXXXX XXX
X          XXXXXX XXX
X                XXXX
X                XXXX
X          pX      XX
X p                XX
X   p              XX
XX             pp  XX
XXXXXXXXXXXXXXXXXXXXX
XXXXXXXXXXXXXXXXXXXXX