XXXXXXXXXXXXXXXXXXX
XX X  X XXXXXX     
XXDX  X XXXX   X   
XX    X XXXXXXXXX X
XX XX   XXXXXXXXX X
X      XXXXXXXXXXXX
X X     XXXXXXXXXXX
X X XX  XXXXXXXXXXX
X    XXXXXXXXXXXXXX
X  XXXXXXXXXXXXXXXX
XX XXXXXXXXXXXXXXXX
X  XXXXXXXXXXXXXXXX
XXXXXXXXXXXXXXXXXXX
XXXXXXXXXXXXXXXXXXX
XXXXXXXXXXXXXXXXXXX
XXXXXXXXXXXXXXXXXXX
XXXXXXXXXXXXXXXXXXX
XXXXXXXXXXXXXXXXXXX
XXXXXXXXXXXXXXXXXXX