XXXXX XXX XXXXXXX
XXXXXXXXXXXXXXXXX
XXXXXXXXX XXXXXXX
XXXXXXXXX XXXXXX 
XXXXXXXXX XXXX X 
XXXXXXXXX    p X 
XXXXXXX          
XXXXXXXXXXXDX    
XXXXXXXXX   X    
XXXXXX    XX  XXX
XXXXX  XXXXX XXX 
XXXXXXXXXXXXXXXX 
XXXXXXXXXXXXXXXXX
XXXXXXXXXXXXXXXXX
XXXXXXXXXXXXXXXXX
XXXXXXXXXXXXX XXX
XXXXXXXXXXXXX  XX