XXXXXXXXXXXXXXXXXXXXXXXX
XXXXXXXXXXXXXXp XXXXXXXX
XXXXXXXXXXXXXX      XXXX
XX  p  XXXXXXX  XXX XXXX
XX     XXXXXXXX XXX XXXX
XX     XXXXXXXX XXX XXXX
XX    pXXXXXXXX XXX XXXX
XX     XXXXXXXX XXX XXXX
XX     XX   XXX XXX XXXX
X      XX   XXX XXX XXXX
X           XXX XXX XXXX
X           XXX XXX XXXX
XX          XXX XXX XXXX
XX     X    XXX XXX XXXX
X           XXX X    XXX
X     p     pXX X    XXX
XX                   XXX
XX              X    XXX
XX              XXXXXXXX
XX           XX XXXXXXXX
XX             XXXXXXXXX
XX         XXXXXXXXXXXXX
XXXXXXXXXXXXXXXXXXXXXXXX
XXXXXXXXXXXXXXXXXXXXXXXX