XXXXXXXXXXXXXXXXX
XXXXXXXXXXXXXXXXX
XXXXXXXXXXXXXXXXX
XXX  XXXXXXXXXXXX
XXX  XXXXXXXXXXXX
XX   XX   XXXXXXX
XX   XX   XXXXXXX
XX   DX      XXXX
XX           XXXX
XX  X XX XXXXXXXX
XX  X XX XXXXXXXX
XX  X XX XXXXXXXX
XXX    X   XXXXXX
XXX        XXXXXX
XXXX    XXXXXXXXX
XXXXXXXXXXXXXXXXX
XXXXXXXXXXXXXXXXX