XXXXXXXXXXX
XX  XXXXXXX
XX  XXXXXXX
XXX XXXXXXX
X    XXXXXX
X        XX
XX   XXX XX
X   XXX  XX
X        XX
XXXXXXXXXXX
XXXXXXXXXXX