XXXXXXXXX
X  XX  XX
X      XX
X  XXX XX
X  X   XX
X  X pXXX
X    XXXX
XXXXXXXXX
XXXXXXXXX