XXXXXXXXXXXXX
XXXXXXXXXXXXX
XXXXXXXXXXXXX
XXXXXXXXXXXXX
XX   XXXXXXXX
XX      XXXXX
XX   XX XXXXX
X     X XXXXX
X        XXXX
X        XXXX
X    X   XXXX
XXXXXXXXXXXXX
XXXXXXXXXXXXX