XXXXXXXXXXXXXXXXXXXXX
XXXXXXXXXXXXXXXXXXXXX
XXXXXXXXXXXXXXXXXXXXX
XXXXXXXXXXXXXXXXXXXXX
XXXXXXXXXXXXXXXXXXXXX
XXXXXXXX  XXXXXXXXXXX
XXXXXXXX  XXXXXXXXXXX
XXXXXXXX       XXXXXX
X   pXXXp XXXX XXXXXX
X p   XXX XXXX XXXXXX
X     XXX XXXX X   XX
X        XXXXX X   XX
X                  XX
X  p     XXXXX X   XX
XX                 XX
XX    XXXXXXX  XXXXXX
XX    XXXXXXXXXXXXXXX
XXXXXXXXXXXXXXXXXXXXX
XXXXXXXXXXXXXXXXXXXXX
XXXXXXXXXXXXXXXXXXXXX
XXXXXXXXXXXXXXXXXXXXX