XX XX XXX
XXXX   XX
XXXX X  X
XXX  X   
XXXXXX   
XXXXXXX X
XXXXXXXXX
XXXXXXXXX
XXXXXXXXX