XXXXXXXXXXX
XXXXXXXXXXX
X  XXXXXXXX
X    XXXXXX
XX X XXXXXX
X    XXXXXX
X       XXX
X       XXX
X       XXX
XXXXXXXXXXX
XXXXXXXXXXX