XXXXXXXXXX
XX  XXXXXX
XX   XXXXX
XXX  X  XX
XXX     XX
X    XX XX
X      XXX
XX   XXXXX
XXXXXXXXXX
XXXXXXXXXX