XXXXXXXXXX
XXX  XXXXX
XXX  XXXXX
Xp X XXXXX
X  X XXXXX
X  X   XXX
X      XXX
XXXXXXXXXX
XXXXXXXXXX
XXXXXXXXXX