XXXXXXXXXXXX
XXXXXXX  XXX
XXX      XXX
XX  XXX   XX
XX   XX   XX
XX   XX   XX
XXX   XXXXXX
XXX   XXXXXX
XXXXXXXXXXXX
XXXXXXXXXXXX
XXXXXXXXXXXX
XXXXXXXXXXXX