XXXXXXXXX
XXXXX  XX
X  D   XX
X pXXX XX
X pX  DXX
X     XXX
X    XXXX
XXXXXXXXX
XXXXXXXXX