XXXXXXXXXXX
XXX XXXXXX 
XXX XXXXXX 
XXX XXXXXX 
XXX    XXX 
XXXXXX     
XXXXXXXX   
XXXXX      
XXXXXXXX   
XXXXXXXXX X
XXXXXXXXX X