XXXXXXXXXXXXXXXX XXXXXXX
X XX         XX  XXXXXXX
X XXX        XX   XXXXX 
X  XX X X    XX  XXXXX  
XX XXXX X    X  XXXXX  X
XX XXX  X    X  XXXXXXXX
XX XXX XX       XXXXXXXX
XX  XX  X   X     XXXXXX
XXX D   X XXX XXX XXXXXX
XXXXX   X XXX XXX XXXXXX
XXXXXX XX   X XXX XXXXXX
XXXXX  XXXX X XXX XXXXXX
XXXXX   XXX  pXXX XXXXXX
XXXX  p XXX    XXXXXXXXX
XXXXX XXXXXX   XXXXXXXXX
XXXX  XXXXXXXX XXXXXXXXX
XXXX XXXXXXXXX XXXXXXXXX
XXXX XXXXXXXXX XXXXXXXXX
XXXX XXXXXXXXXXXXXXXXXXX
X XX XXXXXXXXXXXXXXXXXXX
X   XXXXXXXXXXXXXXXXXXXX
XXXXXXXXXXXXXXXXXXXXXXXX
XXXXXXXXXXXXXXXXXXXXXXXX
XXXXXXXXXXXXXXXXXXXXXXXX