XXXXXXXXXXXXXXXXXXXXX
XXX  XXXpXXX   p     
XXX      XXXX XXp X X
XXXXXX    X   XXXXXX 
XXXXXX      XXXXXXXXX
XXX     XX   XXXXXXXX
XX pXXXXXXX  XXXXX   
XX XXXXXXX   XXXXX  D
XXXXXXXXXXXX XXX   D 
XXXXXXXXXXXX XX    X 
XXXXXXXXX        X X 
XXXX D D  XX     XXXX
XXXXX   X X      X XX
XXXXX   X   XXD      
XXXXX X X XXXXXXXXXX 
XXXXXXX   XXXXXXXX   
XXXXXXX             X
XXXXXXXXX X  X XXXXXX
XXXXXXXXXXXX XXX XX  
XXXXXXXXX           X
XXXXXXXXXXX  XXXXXXXX