XXXXXXXXXXX
XXXXXXXXXXX
XXXXXXXXXXX
XXX  XX  XX
XXX  D   XX
X  X  XX XX
X     XX XX
X     X  XX
X        XX
XXXXXXXXXXX
XXXXXXXXXXX