XXXXXXXXXXXXXXXXXXXXXXX
XXXXXXXXXXXXXXXXXXXXXXX
XXXXXXXXXXXXXXXXXXXXXXX
XXXXXXXXXXXXXXXXXXXXXXX
XXXXXXXXXXXXXXXXXXXXXXX
XXXXXXXXXXXXXXXXXXXXXXX
XXXXXXXX  XXXXXXXXXXXXX
XXXXXXXX  XXXXXXXXXXXXX
XXXXXXXX  XXXXXXXXXXXXX
XXXXX  X  XXXXXXXXXXXXX
XXXX      XXXXXXXXXXXXX
XXX  X    XXX    XXXXXX
XXX  X X XXXX    XXXXXX
XXX     D        XXXXXX
XXX  X X XXXXp   XXXXXX
XXXp X   XXXXXXXXXXXXXX
XXXXXX   XXXXXXXXXXXXXX
XXXXXX   XXXXXXXXXXXXXX
XXXXXX              XXX
XXXXXX   XXXXXXXXX   XX
XXXXXX               XX
XXXXXXXXXXXXXXXXXXXXXXX
XXXXXXXXXXXXXXXXXXXXXXX