XXXXXXXXXXX
XXXXXXXXXXX
XXXXXXXXXXX
XXXXX pXXXX
X  XX  XXXX
X        XX
X        XX
XX    X  XX
XX     p XX
XXXXXXXXXXX
XXXXXXXXXXX