XXXXXXXXXX
XXX XX XXX
XXX XXD XX
XXX XXX   
XXXXXXX   
XXXXXX D X
XXXXXXX   
XXXXXXXX  
 XXXXXXXX 
XXXXXXXX  