XXXXXXXXXXXXXXXXXXX
XXXXX   XXXXXXXXXXX
XXXXX XXXXXX XX    
XXX   XXXXX     X  
XXX  XXXXXX       X
XXX         X    XD
XX   XXXX XXXXXXXX 
XXXXXXXXXXXXXXXXXX 
XXXXXXXXXXX    XXX 
XXXXXXXXXX  X     D
XXXXXXX X     X    
XXXXXXX   X        
XXXXXXX XX    X    
XXXXXXXXXX  X      
XXXXXXXXXXXXXXXXX  
XXXXXXXXXXXXXXXXXX 
XXXXXXXXXXXXXXXXXXX
XXXXXXXXXXXXXXXXXXX
XXXXXXXXXXXXXXXXXXX