XXXXXXXXXX
XXXXXX  XX
X  X    XX
X       XX
X       XX
X       XX
X    X  XX
XXXXXXXXXX
XXXXXXXXXX
XXXXXXXXXX