XXXXXXXXXXXXXXXX
XXXXXXXXXXXXXXXX
XXXXX  XXXXXXXXX
XXXX   XXXXXXXXX
XX     XXXXXXXXX
XX           XXX
XX p   XXXXX XXX
XXXX X X   X XXX
XXXX       X XXX
XXX    X   X XXX
XXX     X     XX
XX    p X     XX
XX      XXXXXXXX
XX    XXXXXXXXXX
XXXXXXXXXXXXXXXX
XXXXXXXXXXXXXXXX