XXXXXXXXXXXXXXXXX
XXX  XXX X  X XXX
XX  XXXX X  XpXXX
XX  XXXX   XX XXX
XX  XXXXXX  X XXX
XX   XXXXXX   XXX
X    XXXXXX XXXXp
X    XXXX   XXX  
X X   XXX XXXXXXX
X  X  XXX XXXXXXX
X XXX p XXXXXXXXX
X XXXX  pXXXXXXXX
X XXXXX  XXXXXXXX
X XXXXX XXXXXXXXX
X XXXXXXXXXXXXXXX
XXXXXXXXXXXXXXXXX
XXXXXXXXXXXXXXXXX