XXXXXXXXXXXX XXXXXXXXXXX
XXXXXXXXXXX  XXXXXXXXXXX
XXXXXXXXXX   XXXX X  XXX
XXXXXXXXXX   XXXXpXX XXX
XXXXXXXXXp X     pXX XXX
XXXXXXXXX XXXXXX  XX  XX
XXXXXXX   XXXXXXX  XX  X
XXXXXXXXD XXXXXXX  XXX X
XXXXXXXX   XXXXXX  XXX X
XXXXXXX D DXXXXX   XXX  
XXXXXXX pX XXXXX   XXXXX
XXXXXXXX   XXXXX  XXXX  
XXXXXXXX  XXXXXXX   XXX 
 XXXXXX   XXXXXXX X     
XXXX    XD  XXXX  XXX  X
XX   XXXXXX  XX   XXX  X
XXX XXXXXXX DXXX  XXX  X
XXX  XXXX   XXXX  XXX  X
X     XXX XXXXXXX XXX   
XXXXXXXXX XXXXXXX XX   X
XXXXXXXXX XXXXXXX     XX
XXXXXXXXX  XXXXXXXX   DX
XXXXXXpXXX XXXXXXX   D  
XXXXXX  XX XXXXXX     XX