XXXXXXXXXXXXXXX
XXXXXXXXXXXXXXX
XXXXXXXXXXXXXXX
XXX    XXXXXXXX
XXX        XXXX
XXXXX XXXX XXXX
XX     X    XXX
XX     X    XXX
X     XX    XXX
X     XXXXXXXXX
X        XXXXXX
X     X      XX
XXXXX        XX
XXXXXXXXXXXXXXX
XXXXXXXXXXXXXXX