XXXXXXXXXXXXXXXXXXX
XXXXXXXX  XXXXXXXXX
XXXXXXX  XXXXXXXXXX
XXXXXX  XXXXXXXXXXX
XXXXXX XXXXXXXXXXXX
XXXXXX   XXXX   XXX
XXXXXXX   XXXXX XXX
XXXXXXX X XXXXX X X
XXXXXXX X XXXXX X  
XXXXXXX   XX    XXX
XXXX     XXXX   XXX
XXXXX  XXXXp   XXXX
XXXX   XXXX   XX XX
XXXX    XXX      XX
XX     X  X  XX  XX
X  XXX  X     X   X
X XXXX  X  X      X
XXXXXX         X   
XXXXX         X D X