XXXXXXXXXXXXXXXXXX
XX  XXXXXXXXXXXXXX
XX  XXXXXXXXXXXXXX
XXX XXXXXXXXXXXXXX
XXX XXXXXXXXXXXXXX
XXX XXXXXXXX    XX
XXX XXXXXXXX    XX
XXX XXXX     p  XX
XX     X XXX    XX
X   p           XX
X            XXXXX
X          X XXXXX
X    X     X XXXXX
XX  XXXXXXXX XXXXX
XXX XXXXXX    XXXX
XXX           XXXX
XXXXXXXXXXXXXXXXXX
XXXXXXXXXXXXXXXXXX