XXXXXXXXXX
XXXXXXXXXX
XXXXXp XXX
XX     XXX
XX  XXDXXX
X    X XXX
X  p D  XX
X   XX  XX
XXXXXXXXXX
XXXXXXXXXX