XXXXXXXXXXXXXXXXXXXXXXX
XXXXXXXXXXXXXXXXXXXXXXX
XXXXXXXXXXXXXXXXXXXXXXX
XXXXXXXXXXXXXX      XXX
XXXXXXXXXXXXXX   p  XXX
XXXXXXXXXXXXXX      XXX
XXXXXXXXXXXXXX    p XXX
XXXXXX    XXXX      XXX
XXXXXX    XXXXXXX XXXXX
XX        XXXXXXX XXXXX
XX        XXXXXXX XXXXX
X         XXXXXXX XXXXX
X          XXXXXX XXXXX
X          XXXXXX XXXXX
X                    XX
X             X      XX
X                    XX
X p  p               XX
XXXXXXX  p    XXXXXXXXX
XXXXXXX       XXXXXXXXX
XXXXXXX    pXXXXXXXXXXX
XXXXXXXXXXXXXXXXXXXXXXX
XXXXXXXXXXXXXXXXXXXXXXX