XXXX XXXXXXXXX XXXXXXXX
XXXX     XXXXX XXXXXXXX
XXXXXX  XXXX   XXXXXXXX
X      XXXXX XXXXXXXXXX
XXXX   XXXX  XX   XXXXX
XXXXX  XXX  X   X  XXXX
XXXX  DXXX XX   XX XXXX
XXXX X       XX  X  XXX
X                   XXX
XXXX XXXX    XXX XX XXX
XXX   XXXXX X    XX    
XXXX  XXXX    XXXXXXXXX
X      XXX  XD XXXXXXXX
X  XXXXXXX       XXXXXX
X  XXXXXXXX       XXXXX
XX XXXX XXX XXX   XXXX 
XX XXX  XXX XXX X   XX 
X      XXXX XXX XX  X  
X XX XXXXX  XXX XX     
X XXD XXXX XX      X XX
X X   XXXX  XXXX p  pXX
X X  XXXXXX    X XXX XX
XXXX XXXXXXXXX X XX   X