XXXXXXXXXXXX XX
XXXXXXXXXXXXXXX
XXXXXXX  XXXXX 
XXXX     XX D  
XXXX XXX       
X    XXX    XX 
X  XXXXX XXXXXX
X  XXXXXXXX  XX
X XXXXXXXXX   X
X XXXX    X X  
XXXX      D X  
XXXX XXXXX     
XXXXXXXXXXXX   
XXXXXXXXXXXX X 
XXXXXXXXX    XX