XXXXXXXXXX XX
X  XXXXX   XX
X XXXXD    XX
X XXXX XX  XX
X  XXX XX   X
XX XXX    X X
X p   XX  X X
XXXXX XX    X
XXXXX XX   XX
XXXXXXXXXX XX
XXXXXXXXXX XX
XXXXXXXXXX XX
XXXXXXXXXX XX