XXXXXXXXXXX
XXXXXXXXXXX
XXXXXp XXXX
X  XX  XXXX
X  DXX XXXX
XX  XX XXXX
XX     XXXX
XX     XXXX
XX    XXXXX
XXXXXXXXXXX
XXXXXXXXXXX