XXXXXXXXXXXXXXXXXXX
XXXXX       XXXXXXX
XXXXXXX D   XXXXXXX
XXXXXX  D   XXXXXXX
XXXXXXX      XXXXXX
 XXXXXX  XD  XXXXXX
XXXXXXX XXX p  XXXX
XXXXXX  XXX   XXXXX
XXXXXX XXXXXX XXXXX
XXXXXX XXXXX  XXXXX
XXXXXD  XXXXXXXXXXX
X XXXX  XXXXXXXX   
X  XXX  XXXXXXXX XX
XX XXX  XXXXXXX  X 
XX DX  XXXXXXXXXX  
XXX   XXXXXXXXXX  X
XXD XXXXXXXXXXXX  X
XXXXXXXXXXXXXXXXXXX
XXXXXXXXXXXXXXXXXXX