XXXXXXXXXXXXXXXXXXXX
XXXXXXX   XXXXXXXXXX
XXXX      XXXXXXXXXX
XXXX XXX XXXXXXXXXXX
XXX  XXX XXXXXXXXXXX
XXX  XXX XXXXXXXXXXX
XXX      XXXXXXXXXXX
XXX  XX DXXXXXXXXXXX
X        XXXXXXXXXXX
X        XXXXXXXXXXX
X        XXXXXXXXXXX
X      DXXXXXXXXXXXX
X       XXXXX     XX
XXX       XXX    pXX
XX p              XX
XX        XXX     XX
XX  p   p XXX     XX
XXXX      XXXXXXXXXX
XXXXXXXXXXXXXXXXXXXX
XXXXXXXXXXXXXXXXXXXX