 XXXXXXXXXXXXXX XXXX
XXXXXXXXXXX XXXXXXXX
XXXXXXXXXXX   XXXXXX
XXXXXXXXX XXX  XXXXX
XXXXXXXXXDXXX  XXXXX
XXXXXXXX  XXX  XXXXX
XXXXXX    XXXX   XXX
XXXXXXX X   XXXX XXX
XXXXXXX   XXXXXX XXX
XXXXXXXp XXXXXXX  XX
XXXXXXX    XXXXXX XX
XXXXXXXXX XXXXXXX XX
XXXXXXX    XXXXXXDXX
XXXXXXXX    XX XX XX
XXXD XXX   XXX XX DX
XXX  XXX  XX   X    
XXXXD     XX  XX X  
XXXXXXXX    X XX X X
XXXXXXX    D  XX X X
XXXXXXXX     XXX X X