XXXXXXXXXXXXXXXXX
XXXXXXXXXXXXXXXXX
XXXXXXXXXXXXXXXXX
XXXXXXXXXXXXXXXXX
XXXXXXXXXXXXXXXXX
XXXXX   XXXXXXXXX
XXXXX   XXXXXXXXX
XXXX   XXXXXXXXXX
XXXX  pXXXXX   XX
XXXX           XX
XXXXXD    XX   XX
XXX       XXXXXXX
XXX       XXXXXXX
XXX       XXXXXXX
XXX    XXXXXXXXXX
XXXXXXXXXXXXXXXXX
XXXXXXXXXXXXXXXXX