XXXXXXXXXXXXXXXXXXXX
XXXXXXXXXXXXXXXXXXXX
XXXXXXXXXXXXXXXXXXXX
XXXXXXXXXXXXXXXXXXXX
XXXXXXXXXXXXXXXXXX X
XXXXXXXXXXXXXXXXXX  
XXXXXXXXXXXXXXXXXXXX
XXXXXXXXXXXXXXXXXXXX
XXXXXXXXXXXXXXXXXXXX
XXXXXXXXXXXXXXXXXXXX
X XXXXXXXXXXXXXXXXXX
X  XXXXXXXXXXXXXXXXX
XX  XXXXX  XXXXXXXXX
XXX  XXXXX   XXXXXXX
XXXX  XXXXX     XXXX
XXXXX   XXX     XXXX
XXXXX    XX  XX    X
X       XX   XX  XX 
XX     XX D  DX   X 
XX    XXX   X X  XXX