XXXXXXXXXXXXXXXXXXXXX XX
XXXXXXXXXXXXXXXXXXXXXXXX
XXXXXXXXXXXXXXXXXXXXXXXX
XXXXXXXXXXXXXXXXXXXXXXXX
 XXXXXXXXXXXXXXX  XXXXXX
XXXXXXXXXXXXXXXXX XXXXX 
XXXXXXXXXXXXXXX   XXXXXX
XXXXXX   XXXXXX     XXXX
XXXX   XXXXXXXX XX  XXXX
XXXX  XXXXXXXX  XD  XXXX
XXXD  XXXXXXXXX    XXXXX
XXX   XXXXXXXXXXX  XXXXX
XXX   XXXXXXXXXXX DXXXXX
XXX   XXXXXXXXX    XXXXX
XXD X  XXXXXXXXp  XXXXXX
XX  XX XXXX XXX    XXXXX
XX  XX XXXX  X  XX  XXXX
X   XX XXXX XX XXXX XXXX
XX XXX XXXX XXD XXX    X
X  X X XXX  XXX     XX X
XXXX    X  XXXXXXX  X  X
XXXXX   X   XXXXX DXX   
XXXXX   X XXXXXXX XXXXXX
 XXXX      XXXXX  XXXXXX