XXXXXXXXXXXXX
XXXXX   XXXXX
XXXXX  pXXXXX
XXXXX   XXXXX
XXXXXX XXXXXX
X  XX  XXXXXX
X      D   XX
X  XX  XXX XX
XXXXX   XX XX
XXXXX   X  XX
XXXXXX     XX
XXXXXXXXXXXXX
XXXXXXXXXXXXX