XXXXXXXXXXX XXXXX
   XX XXXXXXXXXXX
XXp   XXXXXXXXX  
XXXXXXXX XX p   X
XXXXXXXX XXpXX XX
 XXXXXX     XX   
XXXXXXX XXXXXX XX
XXXXXX  XXX      
XXXXXXXXXXD D X X
XXXXXXXXXX   XXXX
XXXXXXXXXX   XXX 
XXX              
XXXX  XXXXXXX X  
XXX  XXXXXXXXXXXX
XXXXXXXXXXXXXXXXX
XXXXXXXXXXXXXXXXX
XXXXXXXXXXXXXXXXX