XXXXXXXXXXXXX
XXXXXXXXXXXXX
XXXXXXXXXXXXX
X   XXXXXXXXX
X          XX
X   X      XX
X      XXXXXX
X        XXXX
X    p   XXXX
X        XXXX
XXXX     XXXX
XXXXXXXXXXXXX
XXXXXXXXXXXXX