XXXXXXXXXXXX XXXXXXXXXXX
X       XXXpXXXX    XXXX
XX X XX  X  XXXX  X XXXX
XX  p    D              
XXXX X  XXX XXXX   DXXXX
X       XX  XXXX   XXXXX
   X  X  X XXXXX X  XXXX
XX X XXXXX XXXXX    DXXX
XX X XXXXX  XXXXX      X
XX X XXXXX  XXXX  XXXD X
XX X XXXXX XXXXXX XXXX X
XXXX XXXD  XXXXX       X
XXXX XXX X           p  
XXXX  XX XXX XXXD XXXX  
XXX  XXX XX   X  XXXX   
XXX  XXX  X XXXX XXXX  X
XXXX XXXp   XXX  XXXX XX
XXXX XXXX  XXXXD XXXX XX
XXXX XXXXX    XX XXXXXXX
XXXX   XXXXXX  X XXXXXXX
XXXX  XXXXXXXXXX  XXXXXX
XXXXX XXXXXXXXXX  XXXXXX
XXXXX XXXXXXXXXX XXXXXXX
XXXXX XXXXXXXXXXXXXXXXXX