XXXXXXXXXXXXXXXX
XXXXXXXXXXXXXXX 
 XXXXXXXXXXXXXXX
XXXXXXXXXXXXXXXX
XXXXXXXXXXXX  X 
XXXXXXXXXXXX    
XXXXXX   XXX    
XXXXXXXX  X D  X
XX   XXXX       
XXXX  XXX     DD
XXXXX XXXXX     
XXXXX XXXX  XXXX
XXXXX      XXXXX
XXXXXX DXXXXXXXX
XXXXXX XXXXXXXXX
XXXXXXXXXXXXXXXX