XXXXXXXXXX
XXXXXXXXXX
X  X  XXXX
X      XXX
XXXXX  XXX
XXXXX  XXX
XXXXX  XXX
XXXXX  XXX
XXXXXXXXXX
XXXXXXXXXX