XXXXXXXXXXXXXXXXX
XXXXXXXXXXXXXXXXX
XXXXXXXXXXXXXXXXX
XXXXXXXXXXXXXXXXX
X    X    XXXXXXX
X    X      pXXXX
X     X   X  XXXX
X     X   X  XXXX
XXX      XX    XX
XXXp           XX
X      p X     XX
X       pX  XX XX
X        X  XX XX
X             XXX
X        XXXXXXXX
XXXXXXXXXXXXXXXXX
XXXXXXXXXXXXXXXXX