XXXXXXXXXXXXXXXXXXXXXX
XX    XXXXXXXXXXXXXXXX
XX    XXXX   XXXXXXXXX
XX    XXXX        XXXX
XX    XXXXX XXXXX XXXX
XX    XXXXX XXXXX XXXX
XX    XXXXXDXXXXX XXXX
XXXX  XX  X XXXX  XXXX
XXXXDDXX  X XXXX  XXXX
XXXX  XX DX XXXX  XXXX
XXXX  XX  X       XXXX
XX     X  X  XXX  XXXX
XX     X  X  XXX  XXXX
XXp       X  XXXXXXXXX
XX             XXXXXXX
XXX            XXXXXXX
XXX            XXXXXXX
XXX        p   XXXXXXX
XXXX       XXXXXXXXXXX
XXXXXX   p XXXXXXXXXXX
XXXXXXXXXXXXXXXXXXXXXX
XXXXXXXXXXXXXXXXXXXXXX