XXXXXXXXXXX
X  X  XXXXX
X     XXXXX
XXXX  XXXXX
XXXX  XXXXX
XXX  DXXXXX
XXX     XXX
X  X    XXX
Xp  XXXXXXX
XXXXXXXXXXX
XXXXXXXXXXX