XXXXXXXXXXXXXXXXXX
XXXXXXXXXXXXXXXXXX
XXXXXXXXXXXXXXXXXX
XXXXXX    XXXXXXXX
XX   X    XXXXXXXX
XX        XXXXXXXX
XX   XXXXXXXXXXXXX
XXX     XXXXXXXXXX
XX       XXXXXXXXX
XX       XXXXXXXXX
X     p XXXXXXXXXX
X      p   p  XXXX
X p             XX
XX              XX
XXX XX       X  XX
XXX      XXXXXXXXX
XXXXXXXXXXXXXXXXXX
XXXXXXXXXXXXXXXXXX