XXXXXX X
XXXXXXXX
XXXXXXXX
 XXXX   
XXXXXXX 
XXXXXXXX
XXXXXXX 
XXXXXXXX