XXXXXXXXXXXXXXXXXXXXXX
XXXX XXXXDX     XXX   
XXXX XXXXXXX      X   
XXXX   XXXXX   XX     
XXXXX  XXXXXX  XX D   
XXXXX    XXXX  X     X
XXXXXXXX XXXX  X     X
XXXXXXXX XXXX        X
XXXXXXXX XXXX X       
XXXXXXXX XXXX XXD  XXD
XXXXXXX  XXXXXX  X    
X XXXXX  XXXXXX     XX
X XXXXX  XXXXXX  X   X
XDXXXXX  XXXXXX XX  XX
  XXXXX  XXXXXX X    X
XXXXXXX  XXXXXXXXXXDXX
XXXXp    XXXXXXXXX  XX
XXX  XXXXXXXXXXXXX XXX
XXX  XXXXXXXXXXXXX pXX
XXX XXXXXXXXXXXXXXXXXX
XXXXXXXXXXXXXXXXXXXXXX
XXXXXXXXXXXXXXXXXXXXXX