XXXXXXXXXXXXXXXX
XXXXXXXXXXXXXXXX
XXXXXXXXXX    XX
X  XXXXXXX    XX
XX XXXXXXXX    X
X  XXXXXXXX  p X
X XXXXXXX D X pX
X XXXXXXX   X  X
X XXXXXXXX     X
XXXXpXXXXX   X  
XX Dp XXX       
X     XXX D   XX
X       XXX   XX
  XXXX  XXX   XX
XXXXXXX XXX     
XXXXXXX XXX     