D  XXXXX
XX XXXXX
XX XXXXX
X  X  XX
X     XX
XXXXXXXX
XXXXXXXX
XXXXXXXX