XXXXXXXXXXXX XXXX
XXXXXXXXXXXXXXXX 
XXXXXXXXXXXXXXXX 
XXXXXXXXXXXXX    
XXXXXXXX p    XXX
XXXXXXX DXX   XXX
XXXXXXXX     XXX 
XXXXXXXXXXX  XXX 
XXXXXXX         p
XXXXXX  XXXXX    
XXXX   XXXXXX XXX
XXXXDXXXXXXXXXXXX
XX   XXXXXX  X XX
XX X  XXX p      
XX XXD     XXXXXX
XX XXXXXXXXXXXXXX
XXXXXXXXXXXXX  XX