XXXXXXXXXXX
XXXXXXXXXXX
XXX  XXXXXX
XX   XXXXXX
XX XXXXXXXX
XX XXXXXXXX
X  XXXXXXXX
X  XXXXXXXX
X  XXXXXXXX
XXXXXXXXXXX
XXXXXXXXXXX