XXXXXXXXXX
X  XXXXXXX
X  XXXXXXX
XX XX  XXX
XX XX  XXX
X  XXX XXX
X     XXXX
X  XXXXXXX
XXXXXXXXXX
XXXXXXXXXX