XXXXXXXXXXXXXXXXXXXXXXXX
XXXXXXXXXXXXXXXXX   XXXX
XXXXXXXXXXXXXX    XXXX X
XXXXXXXXXXXXXX XXXXX X X
XXXXXXXXXXXXXXXXXXXX    
XXXXXXXXXXXXXXXXXXX     
XXXXXXXXXXXXXXXXXXXXX   
XXXXXXXXXXXXXXXXXXXXX XX
XXXXXXXXXXXXXXXXXXXXX XX
XXXXXXX XXXXXXXXXXXXX XX
XXXX         XX XX X  XX
XXXXXXXX XX  X          
XXXXXXXX  X       D     
XXXXXXXXX           p   
XXXXXXXXX XX XXXXXXXX   
XXXXXXXXXXXXXXXXXXXX   D
XXXXXXXXXXXXXXXXXXXX  X 
XXXXXXX  XXXXXXXXXXX  XX
XX   XX D    XXXX X     
XXXX D  XXXX   D    XXX 
XXXXXXXXXXXX  XXXX      
XXXXXXXXXXXXXXXXXXXXXXXX
XXXXXXXXXXXXXXXXXXXXXXXX
XXXXXXXXXXXX  D XXXXXXXX