XXXXXXXXXXXXX 
XXX    p    XX
XXXXX pD   XXX
XX    X X  XXX
X   X   X    X
XXXXXXX  XX   
XXXXXXXD XXXXX
XXXXXXX  XXXXX
XXXXXX   XXXXX
XXXXXXX XXXXXX
XXXXXXX  XXXXX
XXXXXXXXXXXXXX
XXXXXXXXXXXXXX
XXXXXXXXXXXXXX