XXXXXXXXXXXX
XX  XXXXXXXX
XX   XXXXXXX
XX   XXXXXXX
X    X   XXX
X    X   XXX
X  p XX   XX
X         XX
X      X  XX
X     XXXXXX
XXXXXXXXXXXX
XXXXXXXXXXXX