XXXXXXXXXXXXXXXXXXXX
XXX     XXXXXXXXXXXX
XXX      D       XXX
XXX     XXXXXX   XXX
XXX    D         XXX
XXX   XXXXXXXX   XXX
XXX     XXXXXXXXXXXX
X       XXXXXXX  XXX
X       X      p XXX
X               XXXX
X          XXXXXXXXX
X          XXXXXXXXX
X          XXXXXXXXX
X          XXXXXXXXX
XX            XXXXXX
XX p          XXXXXX
XXXXX        pXXXXXX
XXXXXXX   p   XXXXXX
XXXXXXXXXXXXXXXXXXXX
XXXXXXXXXXXXXXXXXXXX