XXXXXXXXXXX
XXXXXXXXXXX
X  XXXXXXXX
X        XX
XX XXXX  XX
XX XXXX  XX
X    XX  XX
X        XX
XX   XXXXXX
XXXXXXXXXXX
XXXXXXXXXXX