XXXXXX XXXXXX
X XXX       X
X XXX XXXXXXX
X     XXXXXXX
X XXXXXX  XXX
XXXXXXXX     
XXXXXXXXXXXXX
XX DXXXXXXXXX
XX     X XXXX
XXXXXX     X 
XXXXXXXXXX   
XXXXXXXXX  XX
XXXXXXXXXX XX