XXXXXXX XXXX
XXXXX    XXX
XXXXX XX  XX
XXXXXX X  p 
XXXX     X D
XXXX X      
XXXX XXX   X
X  p XXX XXX
XXXXXXXXXXXX
XXXXXXXXXXXX
XXXXXXXXXXXX
XXXXXXXXXXXX