XXXXXXXXXXXXX
XXXXXXXXXXXXX
XXXXXXXXXXXXX
X   XXXXXXXXX
X    D   XXXX
X   XX   XXXX
X        XXXX
X p XXX   XXX
X         XXX
X    XXXXXXXX
XX   XXXXXXXX
XXXXXXXXXXXXX
XXXXXXXXXXXXX