XXXXXXXXXXXXXXXXXXXXXX
XXXXXXXXXXXXXXXXXXXXXX
XXXXXXXXXXXXXXXXXXXXXX
XXXXXXXXXXXXXXXXXXXXXX
XXXX   XXXXXXXXXXXXXXX
XXXXp  XXXXXXXXXXXXXXX
XXXX   XXXXXXXXXXXXXXX
XXXX   XXXXXXXXXXXXXXX
XXXX  XXXXXXXXXXXXXXXX
XX    XXXXXX  XXXXXXXX
X       XXXX  XXXXXXXX
X             XXXXXXXX
XX              XXXXXX
XX  p         X XXXXXX
XX                XXXX
XX                XXXX
XXX               XXXX
XXX          p  XXXXXX
XX              XXXXXX
XX              XXXXXX
XXXXXXXXXXXXXXXXXXXXXX
XXXXXXXXXXXXXXXXXXXXXX