XXXXXXXXXXXXXXX
XXXXXXXXXXXXXXX
XXXXXXXXXXXXXXX
XX    XX    XXX
XX          XXX
XX X XXX    XXX
Xp   XXXXX XXXX
X    XXXXX XXXX
X   XX   X XXXX
X   XX   XDXXXX
XX  D     XXXXX
XX  XX   XXXXXX
XXXXXXXXXXXXXXX
XXXXXXXXXXXXXXX
XXXXXXXXXXXXXXX