XXXXXXXXX
XXXXXXXXX
XXXXXXXXX
XXXXXXXXX
XXXXX    
XXXXXD   
XXXXXXXX 
XXXXXXXXX
XXXXXXXXX