XXXXXXXXXXXXXX
XXXXXXXXXXXXXX
XXXXXX  XXXXXX
X  D    XXXXXX
X   XXX XXXXXX
X p XXXDXXXXXX
X   XXX X   XX
X           XX
X     X X   XX
X      XXXXXXX
XX   XXXXXXXXX
XXXXXXXXXXXXXX
XXXXXXXXXXXXXX
XXXXXXXXXXXXXX