XXXXXXXXXXXXXXXXXXXXX
XXXXXXXXXXXXXXXXXXXXX
XXXXXXXXXXXXXXXXXXXXX
X    XXXXXXXXXXXXXXXX
X    XXXXXXXXXXXXXXXX
X     XXXXXXXXXXXXXXX
X     XXXXXXXXXXXXXXX
X         XXXXXXXXXXX
XXX        D  XXXXXXX
X        pXXX XXXXXXX
X          XX XXXXXXX
XX         XX XXXXXXX
X          XX XXXXXXX
X               XXXXX
X        X      XXXXX
X        X      XXXXX
X               XXXXX
XXX   p         XXXXX
XXX     XX      XXXXX
XXXXXXXXXXXXXXXXXXXXX
XXXXXXXXXXXXXXXXXXXXX