XXXXXXXXXXXXXXXXXXXXXX
XXXXXXXXXXXXXXXXXXXXXX
XXXXXXXXXXXXXXXXXXXXXX
XXXXXXXXXXXXXXXXXXXXXX
XXXXXXXXXXXXXXXXXXXXXX
XXXXXXXXXXX      XXXXX
XXX     XXX      XXXXX
X                XXXXX
X                XXXXX
X   X DXXXX      XXXXX
X                XXXXX
X   X      XX      XXX
X   X      DX      XXX
XX XX  X           XXX
XX XX  XXX  Xp     XXX
XXD         X XXXXXXXX
XX     XXX  X XXXXXXXX
XX       XXXX XXXXXXXX
XX       X      XXXXXX
XX       D      XXXXXX
XXXXXXXXXXXXXXXXXXXXXX
XXXXXXXXXXXXXXXXXXXXXX