XXX XXXXXX XXXXX
XXXXXXX  X XX   
XXXXXXX    X    
XXXXX    X      
XXXXXX          
XXXXXXXX XX X  X
XXXXXXXXXXXX  XX
XXXXXXXXXXXXXXXX
XXXXXXXXXXXXXXXX
XXXXXXXXXXXXXXXX
XXXXXXX XXXXXXX 
XXXXXX    XXXX  
XXXXXX   DXXX  X
XX     XX  X  XX
   XXXXXXX    XX
XXXXXXXXXXXX    