XXXXXXXXXXXXXXXXXXXXXXX
XXXXXXXXXXXXXXXXXXXXXXX
XXXXXXXXXXXXXXXXXXXXXXX
XXXXXXXXXXXXXXXXXXXXXXX
XXXXXXXXXXXXXXXXXXXXXXX
XXXXXXXXXXXXXXXXXXXXXXX
XXXXXXXXXXXXX      XXXX
XXXXXXX D          XXXX
XXXX     XXXXXXX XXXXXX
XXXX             XXXXXX
XXXX             XXXXXX
XXXX    X   XXXX XXXXXX
XXXXXX      XXXX XXXXXX
XXX         XXXX XXXXXX
XXX            XDXXXXXX
XXXXX       XX X XXXXXX
XXXXX       XX     XXXX
XXXXX              XXXX
XXXXXX           XXXXXX
XXXXXXX          XXXXXX
XXXXXXXXXXXXXXXXXXXXXXX
XXXXXXXXXXXXXXXXXXXXXXX
XXXXXXXXXXXXXXXXXXXXXXX