XXXXXXXXXXXXX
XXX   XXXXXXX
XXXXX XXXXXXX
XXXXX  XXXXXX
XXXXX   XXXXX
XXXXX X XXXXX
XXXXX   XXXXX
XXXXX   XXXXX
XXXXX   XXXXX
XXXXX    XXXX
XXXXX     XXX
XXXXXX  X    
XXXX XX XXX X