XXXXXXXXXXXXXXXXXXXXXX
XXXXXXXXXXXXXXXXXXXXXX
XXXXXXX      XXXXXXXXX
XXX   X      XXXXXXXXX
XXX          XX  XXXXX
XXXX XX    XXXX  XXXXX
XXXX XX    XXXX  XXXXX
X  X XX    XXXX  XXXXX
X  X XX          XXXXX
X  XDXX    XXXX  XXXXX
X pD XX    XX    XXXXX
X    X p   XX    XXXXX
X                XXXXX
X          XX    XXXXX
X          XX    XXXXX
X                 XXXX
X                 XXXX
X        XDXX     XXXX
X               XXXXXX
X       XXXXXXXXXXXXXX
XXXXXXXXXXXXXXXXXXXXXX
XXXXXXXXXXXXXXXXXXXXXX