XXXXXXXXXXXXXXX
X  XXXXXXXXXXXX
X           XXX
X  XX   XXX XXX
XX  X   XXXDXXX
XX  X   XXX XXX
XXX XX XXX   XX
XXX XX XXX   XX
XXX    XXX   XX
XXX    XXX   XX
X      X    XXX
X           XXX
XXXXXXXX    XXX
XXXXXXXXXXXXXXX
XXXXXXXXXXXXXXX