XXXXXXXXXXXXXXXXXXXXXX
X  XXXXX  XX   X DXXX 
XXXXXXXX     X   XXX  
XXXXXXXX        XXX  X
XXXXXX                
XXXXXXX   XX   X X  XX
XXXXXXX   X   XX XX XX
XXXXXXX   D  XXX XXXXX
XXXXX        XXX  XXXX
XXXXX  D   X XXXX XXXX
XXXXXXX XX  D XXX  XXX
XXXXXX  XXX   XXXX XXX
XXXXXXX  XX  XXXXX  XX
XXXX   D      XXXX  XX
XXXXXX XX pXXXXXXX  XX
XXXXX  XX  XXXXXXXX XX
XXXXX XX    XXXXXXX XX
XXXXX XXX    XXX    XX
XXXXX XXX   XXXX  XXXX
 XXXX XX  X XXXXX XXXX
XXXXX XXXXX XXXXXXXXXX
XXX   XXXXXXXXXXXXXXXX