XXXXXXXXXXXXXX
XXXXXXXXXXXXXX
XXXXXXXXXXXXXX
XXXXXXXXXXXXXX
XXXXXXXXXXXXXX
X    XXXXXXXXX
X     XXXXXXXX
X    p D   XXX
X          XXX
XXXX   X   XXX
XXXXX  XXXXXXX
XXXXX  XXXXXXX
XXXXXXXXXXXXXX
XXXXXXXXXXXXXX