XXXXXXXXXXXXXXXXXXXX
XXXXXXXXXXXXXXXXXXXX
XXXXXXXXXXXXXXXXXXXX
XXXXXXXXXXXXXXXXXXXX
X    XXXXXXXXXXXXXXX
X    XXXXXXXXXXXXXXX
X   XXXXXXXXXXXXXXXX
X      D      XXXXXX
X   XXXX      XXXXXX
X             XXXXXX
X      X      XXXXXX
XX     XXX XX XXXXXX
X         XXX XXXXXX
Xp     X        XXXX
X               XXXX
X      X        XXXX
X      XXXX     XXXX
XXXXXXXXXXX     XXXX
XXXXXXXXXXXXXXXXXXXX
XXXXXXXXXXXXXXXXXXXX