XXXXXXXXXXXXXXXXX
XXXXXXXXXXXXXXXXX
XXXXXXXXXXXXXXXXX
XX   XXXXXXXXXXXX
XX     D   XXXXXX
XXX XXXXXX XXXXXX
XXX  pXXX  XXXXXX
XXp   XXX  XXXXXX
XX    XXXXXXXXXXX
XX    XX   XXXXXX
XX    XX   XXXXXX
XX         XXXXXX
XX         XXXXXX
XXXXD   XXXXXXXXX
XXXXX   XXXXXXXXX
XXXXXXXXXXXXXXXXX
XXXXXXXXXXXXXXXXX