XXXXXXXXXXXXX
X   XXXXXXXXX
X  p   XXXXXX
XX XXX XXXXXX
X  XX   XXXXX
X  DX  pXXXXX
XX    XX   XX
X          XX
X      X   XX
XXp    XXXXXX
XX   XXXXXXXX
XXXXXXXXXXXXX
XXXXXXXXXXXXX