XXXXXXXXXXXXXXX
XXXXXXXXXXXXXXX
XXXXXXXXXX   XX
XX  p        XX
XX    XXXX   XX
XXX  XXXXXX XXX
XXX       X XXX
X    XXXX X XXX
X    XXXX X XXX
X      XX X XXX
X      XX X XXX
X p         XXX
XX         XXXX
XXXXXXXXXXXXXXX
XXXXXXXXXXXXXXX