XXXXXXXXXXXXXXXXXXXXXX
XXX   XXXXXXXXXXXXXXXX
XXX   XXXXXXXXXXXXXXXX
XX     XXX     XXXXXXX
XX       D     XXX  XX
XX     XXXX  XXXXX  XX
XXXX XXXXXX  XXXXX  XX
XXXX XXXp X         XX
XXXX XXX  X XXXXXX  XX
XXXX XXX  X XXXXXX pXX
XXXX XXX         DX XX
XXXX XXX  X XXXXX X XX
X  X XXX  X XXXXX X XX
X  X   XX X XXXXX X XX
X p     X    XXXX X XX
X       X    XXX  X XX
X      XXD   XXX   XXX
X    X XXX   XXX  XXXX
X     XXXXXXXXXXXXXXXX
XXXXXXXXXXXXXXXXXXXXXX
XXXXXXXXXXXXXXXXXXXXXX
XXXXXXXXXXXXXXXXXXXXXX