XXXXXXXXXXXXXXXXXXXXXXXX
XXXXXXXXX  XXXXXXXXXXXXX
XXXXXX     XXXXXXXXXXXXX
X   XX XXp XXXXXXXXXXXXX
X         XXX    XXXXXXX
X   X   XXXXX    XXXXXXX
XX X    XXXXX    XXXXXXX
XX XD   XXXXX    XXXXXXX
XX XDXXXXXXXXXX XXXXXXXX
XX X       XXXX XXXXXXXX
XX p               XXXXX
XX                 XXXXX
XX    XXXXXX       XXXXX
XX    XXXX   XXDXX XXXXX
XX           XX XX XXXXX
XX X XXXXXX  XX XXDXXXXX
X       X  p    XX XXXXX
X              XXX XXXXX
X       X      XXX XXXXX
XX XXXXXX          XXXXX
XX                 XXXXX
XXXXXXXXXXXXXXXXX  XXXXX
XXXXXXXXXXXXXXXXXXXXXXXX
XXXXXXXXXXXXXXXXXXXXXXXX