XXXXXXXXXXXXXXXXXXXXX
XX  p   XXXX XXXXXXX 
XX   X           D   
XX   X      XXXXXX p 
X       DX     X   X 
X   XXXXX  D     XX  
X       X X      D   
  X       XX   pX    
XXXXXXXXXXXXXX     XX
XXXXXXXXXXXXXXX    XX
 XXXXXXXXXXXX    p   
XXXXXXXXXXXXXXXXX XXX
XXXXXXXXXXXXXXXXXXXXX
XXXXXXXXXXXXXXXXXXXXX
XXXXXXXXXX        XXX
XXXXXXDXX  XXXXXX X  
XXXX   p  XXXXXXX X  
XXX  X  XXXXXXXXX    
XX  XXXXXXXXXXXXX XXX
XXXXXXXXXXXXXXXXXXXXX
XXXXXXXXXXXXXXXXXXXXX