XXXXXXXXX
XXXXXXXXX
XXp XXXXX
XX  X  XX
XX    pXX
X   XXXXX
X  XXXXXX
XXXXXXXXX
XXXXXXXXX