XXXXXXXXXX
X  XXXXXXX
X  XXXXXXX
XX   XXXXX
XX   XXXXX
XX   XXXXX
X    X  XX
X      pXX
XXXXXXXXXX
XXXXXXXXXX