XXXXXXXXX
XXXXXXXXX
XXXXXXXXX
XXXXXp XX
X  XX  XX
X     XXX
XXXXXXXXX
XXXXXXXXX
XXXXXXXXX