XXXXXXXXXXXXXXX
XXXXXX  XXXXXXX
XXXXXXDXXXXXXXX
XXXXXXXX   XXXX
XXXXXXXX     Xp
XXXXXXXX   X  p
  XXXXXX       
X XXXX   XXX   
X XXXXXXXXXX   
X    XXXXXXX XX
XXX  XXXXXXXXXX
XXXX       XXXX
XXXXXXXXXX    X
XXXXXXXXXXXXX  
XXXXXXXXXXXXXXX