XXXXXXXXXXXXXXXXXXXXX
XXXXXXXXXXXXXXXXXXXXX
XXXXXXXXXXXXXXXXXXXXX
X    XXXXXXXXXXXXXXXX
Xp         XXXXXXXXXX
X    XXXXX XXXXXXXXXX
XXXXXXXXXX XXXXXXXXXX
XXXX    XX XXXXXXXXXX
XX              DXXXX
XX         XXXXX XXXX
XX  XX       XXX XXXX
XXX XX       XXX XXXX
XXX XX   p   XXX XXXX
XXX            p   XX
XXX     p          XX
XXXXX       X      XX
XXXXXXXX    X      XX
XXXXXXXXXXXXXXXXXXXXX
XXXXXXXXXXXXXXXXXXXXX
XXXXXXXXXXXXXXXXXXXXX
XXXXXXXXXXXXXXXXXXXXX