XXXXXXXXXXXXXXXXXXX
XXXXXXXXXXXXXXXXXXX
X    XXXXXXXXXXXXXX
X    XXXXXXXXXXXXXX
X    XXXXXXXXXXXXXX
X    XXXXXXXXXXXXXX
XX  XXXXXXXXXXXXXXX
XX    p  XXXXXXXXXX
XX       XXXXXXXXXX
XX       XXXXXXXXXX
X       p  XXXXXXXX
X          XXXXXXXX
XX          XXXXXXX
Xp            XXXXX
X      XXXX   XXXXX
XX       XX   XXXXX
XXX           XXXXX
XXXXXXXXXXXXXXXXXXX
XXXXXXXXXXXXXXXXXXX