XXXXXXXXXXXXXXXXX
XXXXXXX X   XXXX 
XXXXXX      XXX  
XXXX    XXXD X   
XXXX    XXXX     
XXXX XXXXXXXXp   
XXD  XXXXXXXXXXXX
XXXXXXXXXXXXXXXXX
XXXXXXXXXXXXXXXXX
XXXXXXXXXXXXXXXXX
XXXXXXXXXXXXXXXXX
XXXXXXXX        D
XXXXXXXX XXXX    
XXXXX   XXX XX p 
XXXXX X     XX X 
XXXXXXXXX     pXX
XXXXXXX   XX  XXX