XXXXXXXXXXXXXXXXXXX
XXX  X      XXXX  X
XXXDXX  X    XXX  X
  X  X    pXXXXX  X
XXXX X   X XXXXX XX
XXXp X  p  XXX    X
XXXX XX  X  XX XXXX
XXXX X   X  X  XXXX
XXXX  pX XXp  XXXXX
XXXXXX   XXp   XXXX
XXXXXX      XX  XXX
XXXXXX D  XX    XXX
XXXXXXX   X  XXXXXX
XXXXXX  X X XXXXXXX
XXXXXXXXXX    XXXXX
XXXXXXXXXXXXX XXXXX
XXXXXXXXXXXXXXXXXXX
XXXXXXXXXXXXXXXXXXX
XXXXXXXXXXXXXXXXXXX