XXXXXXXXXXXXXXXXXXX
XXXXXXXXXXXXXXXXXXX
X   XXXXXXXXX    XX
X     XX         XX
XXDXX XX XXXX p  XX
XX X     XXXXXX XXX
XX X     XXXXXX XXX
XX X     XXXXXX XXX
XX XX      XXXX XXX
XXDXX      X     XX
XX XX  X XXX     XX
XX  p  X XXX     XX
X   p      X     XX
X          X p   XX
X  p       XXX XXXX
X             XXXXX
X     p XXXXXXXXXXX
XXXXXXXXXXXXXXXXXXX
XXXXXXXXXXXXXXXXXXX