XXXXXXXXXXXXXXXXXXX
XXXXXXXXXXXXXXXXXXX
XXXXXXXXXXXX   XXXX
XXXXXXX        XXXX
X   XXX XXXX   XXXX
X  p      XX     XX
XX XXXX XDXX  p  XX
XX        XX p   XX
XX               XX
X         XX     XX
X         XXXXXXXXX
XXXX      XXXXXXXXX
XXXXX       XXXXXXX
XXXXX       XXXXXXX
XXXXX       XXXXXXX
XXXXXXX     XXXXXXX
XXXXXXXXXXXXXXXXXXX
XXXXXXXXXXXXXXXXXXX
XXXXXXXXXXXXXXXXXXX