XXXXXXXXXXXXXXXXXXXXX
XXXXXXXXXXXXXXXXXXXXX
XXXXXXXXXXXXXXXXXXXXX
X  XXXXXXXXXXXXXXXXXX
X       XXXXXXXXXXXXX
XX XX   XXXXXXXXXXXXX
XX XX   XXXXXXXXXXXXX
XX XX   XXXXXXXXXXXXX
XX X      XXXXXXXXXXX
XX X         D XXXXXX
XX        XXXX XXXXXX
X    X      XX XXXXXX
X  p           XXXXXX
X      p    X  XXXXXX
X              XXXXXX
X              XXXXXX
X                XXXX
XX               XXXX
XX              XXXXX
XXXXXXXXXXXXXXXXXXXXX
XXXXXXXXXXXXXXXXXXXXX