XXXXXXXXXXXXXXXX
X    XXXXXXXXXXX
X             XX
XXX XXXXXXXXX XX
XXX XXXXXXXXX XX
XXX XXXXXXXXX XX
XXX   pXXXXXX XX
XXX    XXXXX  XX
XXX           XX
XXX       XXXXXX
XXXX XX   XXXXXX
X  X XX    XXXXX
X   XXX    XXXXX
XXXXXXXXXXXXXXXX
XXXXXXXXXXXXXXXX
XXXXXXXXXXXXXXXX