XXXXXXXXX
XXXXXXXXX
XXXXX  XX
XXXXX pXX
XXX  X XX
X     XXX
X  DXXXXX
XXXXXXXXX
XXXXXXXXX