XXXXXXXXXXXXXXXXXXX
XXXXXX   XXXXXXXXXX
XXXXXX   XXXXXXXXXX
XXXXXX   XXXXXXXXXX
XXXXXX   XXXXXXXXXX
X   XX   XXXXXXXXXX
X   XXX XXXXXXXXXXX
X             XXXXX
X       XXX  pXXXXX
X             XXXXX
XX X      X   XXXXX
X         XXXXXXXXX
X  p      XXXXXXXXX
X              XXXX
X  p   XXXXXX   XXX
XX           p  XXX
XXp    XXXXXXXXXXXX
XXXXXXXXXXXXXXXXXXX
XXXXXXXXXXXXXXXXXXX