XXXXXXXXXXXXX
XXXXXXXXXXXXX
XXXXXXXXXXXXX
XXXXXXXXXXXXX
XXX  XXX   XX
XXX        XX
XXX  XXXXXXXX
X  X XXX   XX
X          XX
XXXXX  D   XX
XXXXX  XXXXXX
XXXXXXXXXXXXX
XXXXXXXXXXXXX