XXXXXXXXXXXXXXXXXXXX
XXXXXXXXXXXXXXXXXXXX
XXXXXXXXXXXXXXXXXXXX
X   XXXXXXXXXXXXXXXX
X   XX   XXXXXXXXXXX
X        XXXXXXXXXXX
X   X X XXXXXXXXXXXX
X   X X XXXXXXXXXXXX
XX XX X XXXXXX  XXXX
XX      X   XX  XXXX
XX      X       XXXX
X      XX   XX  XXXX
X   p  XX   XXX XXXX
X     p       X XXXX
X  X     XX     XXXX
XX X            XXXX
XX        D     XXXX
XXXXXXXXXXX p   XXXX
XXXXXXXXXXXXXXXXXXXX
XXXXXXXXXXXXXXXXXXXX