XXXXXXXXXXXXXXXXXXXXXXX
XXXXXXXXXXXXXXXXXXXXXXX
XXXXXXXXXXXXXXXXXXXXXXX
X      XXXXXXXXXXXXXXXX
X      XXXXXXXXXXXXXXXX
X              XXXXXXXX
X    p XX   X  XXXXXXXX
X              XXXXXXXX
XXX  XXXX   X  XXXXXXXX
X      XXX XX  XXXXXXXX
X      XX  XXXXXXXXXXXX
X      XX          XXXX
X          XXXXXX  XXXX
X                  XXXX
X      XXXXXXXXXX  XXXX
X      XXXXXXXXXXXXXXXX
X              p  XXXXX
X      XXXXXX     XXXXX
X                 XXXXX
XXXXXXXXXXXXX     XXXXX
XXXXXXXXXXXXX     XXXXX
XXXXXXXXXXXXXXXXXXXXXXX
XXXXXXXXXXXXXXXXXXXXXXX