XXXXXXXXXXXXXXXXXXX
XXXXXX   XXXXXXXXXX
XXXXXXp  XXXXXXXXXX
XXXXXX   XXXXXXXXXX
XXXXXXX XXXXXp  XXX
XXX             XXX
XXX XXX     XX p XX
XX  XXXXX   XX   XX
XX  D      XXXD  XX
XX  XXXXXX XXXX  XX
XXXX       XXXX  XX
XXXX p          XXX
XX         XX  XXXX
XX             XXXX
XX         XXX XXXX
XX        p   XXXXX
XXX   XXXXXXXXXXXXX
XXXXXXXXXXXXXXXXXXX
XXXXXXXXXXXXXXXXXXX