XXXXXXXXXXXXXXXX
XXXXXXXXXXXXXXXX
XXXXXXXXXXXXXXXX
XXX   XXXXXXXXXX
XXX         XXXX
XXX   XXXXX XXXX
X  X XXXXX  XXXX
X   X pXXX pXXXX
X           XXXX
XXp     XX  XXXX
XX     XXXXXXXXX
XX   XXXXXXXXXXX
XXXXXXXXXXXXXXXX
XXXXXXXXXXXXXXXX
XXXXXXXXXXXXXXXX
XXXXXXXXXXXXXXXX