XXXXX XXX XXXXXXXX XXXXX
XXXXXXXXXXXXXXXXXXXXXXXX
XXXXXXXXXXXXXXXXXXXXXXXX
XXXXXXXXXXXXXXXXXXXXXXXX
XXXXXXXXXXXXXXX X XXXXXX
XXXXXXXXXXXXXXX X XXXXXX
XXX  XXXXXXXXXXD  XXXXXX
XXX  XXXXXXXXXX  XX  XXX
XXXX XXXXXXXXX    XX XXX
XXX DXXXXXXXXX XXXXX XXX
XXX XXXXXXXX   D XX   XX
X p XXXX XXX XX   X   XX
XX XXXXX XXX    XXXpXXXX
XX XXXXX XXXXD  XXX  XXX
XX XXXXX XXXXX pXXX  XXX
X  XXXX  XXXXX  XXX   XX
X XXXX    XXXX    XXXDXX
XXXXXXXX  X  XXX   X   X
XXXXXXX  X   XXXX  XX XX
XXXXXXX  X  XXXXXX  X  X
XXXXXXX XXX  XXXXXX D  X
XXX  X  XXX  XXXXXX    X
XXX    XXXX XXXXXXX    X
XXX     XXX XXXXXXX X   