XXXXXXXXXXXXXXX
X  XXXXXXXXXXXX
X  XXXX p  XXXX
XX         XXXX
X  XXXX   pXXXX
X   XXXXXXXXXXX
X      D DXXXXX
X   XXXXX XXXXX
X   XXXXX XXXXX
XX XXXXXX XXXXX
XX XXXXXX XXXXX
XX XXXXX  XXXXX
XX        XXXXX
XXXXXXXXXXXXXXX
XXXXXXXXXXXXXXX