XXXXXXXXXXXXX
X  XXXXX   XX
X   XX  p  XX
X   X  XX XXX
X   X  XX XXX
X   XXXXX XXX
X    XXXX XXX
XX        XXX
XX   XX  XXXX
XXXXXXX  XXXX
XXXXXXXXXXXXX
XXXXXXXXXXXXX
XXXXXXXXXXXXX