XX XXXXXXXXXXXXXX
XXX    XXXX    XX
XX     XXXXX    X
XX    XXXXX   XXX
XXX X   XXXD  XXX
X     X XXXX XXXX
XX    XXXXX  XXXX
XXX D XXXXX XXXXX
XXX XXXXXX  XXXXX
XX   XXXXX  XXXXX
XXXXXXXXXXX  XXXX
XXXXXXXXXXXXXXXXX
XXXXXXXXXXXXXXXXX
XXXXXXXXXXXXXXXXX
XXXXXXXXXXXXXXXXX
XXXXXXXXXXXXXXXXX
XXXXXXXXXXXXXXXXX