XXXXXXXXXXXXXXXXXXXXXXXX
XXXXXXXXXXXXXXXXXXXXXXXX
XXXXXXXXXXXXXXXXXXXXXXXX
XXXXX      XXXXXXXXXXXXX
XXXXX      XXXXXXXXXXXXX
XXXXX      XXXXXXXXXXXXX
XXXXX         XXXXXXXXXX
XX  X      XX XXXXXXXXXX
X   X      XX XXXXXXXXXX
X   X    XXXX XXXXXXXXXX
X        XXXX XXXXXXXXXX
X               XXXXXXXX
X        XXXXDX XXXXXXXX
X         XX      XXXXXX
X      p          XXXXXX
XX        XXX XDXXXXXXXX
XX            X XXXXXXXX
X                  XXXXX
X p                XXXXX
X     p      pp   XXXXXX
X               XXXXXXXX
XXXXX      XXXXXXXXXXXXX
XXXXXXXXXXXXXXXXXXXXXXXX
XXXXXXXXXXXXXXXXXXXXXXXX