XXXXXXXXXXXXXX
XXXXXXXXXXXXXX
XXXXXXXXXXXXXX
XXX   XXXXXXXX
XXX   XXXXXXXX
XXX p XXXXXXXX
XX     XXXXXXX
XX        XXXX
X   D  X  XXXX
X         XXXX
X      X  XXXX
XX     XXXXXXX
XXXXXXXXXXXXXX
XXXXXXXXXXXXXX