XXXXXXXXXXXXXXXXX
XXXXXXXXXXXXXXXXX
XXXXXXXXXXXXXXXXX
XXXXXXXXXXXXXXXXX
XXX    XXXXXXXXXX
XXX    XXXXXXXXXX
XXX    XXX  pXXXX
XXX       pp XXXX
XXXX    XX   XXXX
Xp X    XX  XXXXX
X     XXXX  XXXXX
XX   XXXXX  XXXXX
XX   XXXXXXXXXXXX
XXX  XXXXXXXXXXXX
XXXXXXXXXXXXXXXXX
XXXXXXXXXXXXXXXXX
XXXXXXXXXXXXXXXXX