XXXXXXXXXXXXXX
XXXXXXXXXXXXXX
XX  XXXXXXXXXX
XX  XXXXXXXXXX
X   XXXXXXXXXX
X       DXXXXX
XX    XX   XXX
XX         XXX
XX        pXXX
XX        XXXX
X    pp  XXXXX
X    p   XXXXX
XXXXXXXXXXXXXX
XXXXXXXXXXXXXX