XXXXX XXXXXXXXXXXXX
XXXXXXXX  XX      X
XXXXXXXX  XXX      
X XXXXXX   XXp X  X
X  XXXXXXp XX  X  X
XXXXXXXXX  XXX    X
XXXXXXXXX  XXX   XX
XXXXXXXX  XXX    XX
XXXXXXX   XXX      
XXXXXXX   XXXX XXXX
XXXXXXX p XXXXXXXXX
XXXXXXX  XXXXXXXXXX
XXXXXXX   XXXXXXXXX
XXXXXXX X XXXXXXXXX
XXXXXXX X XXXXXXXXX
XXXXXXX   XXXXXXXXX
XXXXXXXX  XXXXXXXXX
XXXXXXX  XXXXXXXXXX
XXXXXXX XXXXXXXXXXX