XXXXXXXXX
XX  XXXXX
XX  DXXXX
XXX  XXXX
X    XXXX
X  p XXXX
X    XXXX
XXXXXXXXX
XXXXXXXXX