XXXXXXXXXXXXXXXXXXXXXXX
XXXX    XXXXXXXXXXXXXXX
XXXX    XXXXXXXXXXXXXXX
XXXX        XXXXXXXXXXX
XXXX    XXX XXXXXXXXXXX
XXXXXX XXXX XXXXXXXXXXX
XXXXXX XX     XXXXXXXXX
XXX    XX     XXXX  XXX
XX p   XX     XXXX  XXX
XX                  XXX
XX     X      XXXX  XXX
X   pX    XXXXXXXX  XXX
X    X    XXXXXXXXXXXXX
X    X          XXXXXXX
X    X    XXXXX XXXXXXX
X          XXXX XXXXXXX
X          XX    XXXXXX
X          XX    XXXXXX
X                XXXXXX
XXXXXXXXXXXXX    XXXXXX
XXXXXXXXXXXXX    XXXXXX
XXXXXXXXXXXXXXXXXXXXXXX
XXXXXXXXXXXXXXXXXXXXXXX