XXXXXXXXXXXXXXXXXX
XX    XX  X   XXXX
XX    XX      XXXX
XXX   XX    X  XXX
XXX X XX    XX XXX
XXX   XXXX XXX XXX
XXX   D X  XXX XXX
XXX    XX    X    
XXXXXX X    XXXXX 
XXXXX    XXXXXXXX 
XXXXXXXX  XXXXXXX 
XXXXXXXXX  XXXXXXX
XXXXXXXXXX  XXXXXX
XXXXXXXXXXX XXXXXX
XXXXXXXXXXX  XXXXX
 XXXXXXXXXXXXXXXXX
XXXXXXXXXXXXXXXXXX
XXXXXXXXXXXXXXXXXX