XXXXXXXXXXXX
XXXX p XXXXX
XXXX   XXXXX
XXXX  XXXXXX
XXXX  X   XX
XXXX      XX
XXXX  X   XX
X         XX
X         XX
X   XXXXXXXX
XXXXXXXXXXXX
XXXXXXXXXXXX