XXXXXXXXXXXXXXXXXXXXXX
XXXXXXX XXXXX XXXXXXXX
XXXXXXX    X  XXXXXXXX
XXXXXXX XX X  XXXXX XX
XXXXXXX XX   XXXX     
XXXXXX  XXXXXXXXX XXXX
XXXXXXXXXXXXXXXXXXXXX 
XXXXXXXXXXXXXXXXXXXXX 
XXXXXXXXXXXXXXXXXXXX  
XXXXXXXXXXXXXXXXXX    
XXXXXX  XXXXXXXXXX    
XXXXXX  XXXXXXXXXX   X
XXXXXX  X XXXXX    XXX
XXXXX     XXXXX X X  X
XXX   XX D    X       
XXX    X XXX    XXXXXX
XXX X    XXX      X   
 XXXXXX XXXX          
XXXXXXXXXXX pXX  D    
XXXX         p     XXX
XXXXXXX  XXXX  X    XX
XXXXXXXXXXXXXX    X D 