XXXXXX XXX
XXX XXXXXX
XXXXXXXXXX
XXXXXXXXXX
XXXXXXXXXX
XXXXXXXXX 
XXX   X   
XX  X     
XD    XXXX
X  XXXXXXX