XXXXXXXXXXXXXXXXXXXXXXXX
XXXXXXXXXXXXXXXXXXXXXXXX
XXXXXXXXXXXXXXXXXXXXXXXX
XXXXXXXXXXXXXXXXXXXXXXXX
XXXXXXXXXXXXXXXXXXXXXXXX
XXXXXXXXXXX     XXXXXXXX
XXX       X     XXXXXXXX
XXX       X     XXXXXXXX
X       D    p  XXXXXXXX
X      XXXX     XXXXXXXX
X       XXX     XXXXXXXX
X       XXX     XXXXXXXX
X       XXXXX XXXXXXXXXX
X       XX     XXXXXXXXX
XX             p XXXXXXX
XX      X        XXXXXXX
XX               XXXXXXX
XX           p XXXXXXXXX
XXX             XX    XX
X                     XX
X                     XX
X  p              XXXXXX
XXXXXXXXXXXXXXXXXXXXXXXX
XXXXXXXXXXXXXXXXXXXXXXXX