XXXXXXXXXXXXXXXXXXXX
XXXXXXXXXXXXXXXXXXXX
XXXXXXXXXXXXXXXXXXXX
XX    XXXXXXXXXXXXXX
XX    XXXXXXXXXXXXXX
XX    XXXXXXXXXXXXXX
XX    XXXXXXXXXXXXXX
XXX  XXXXXXXXXXXXXXX
XX      XXXXXXX  XXX
XX               XXX
XXX              XXX
XXX   p  XX pXX  XXX
X     XX XX  XX  XXX
Xp         X XXXXXXX
X     XX     XXXXXXX
XX           XXXXXXX
XXp        p XXXXXXX
XXXXXX       XXXXXXX
XXXXXXXXXXXXXXXXXXXX
XXXXXXXXXXXXXXXXXXXX