XXXXXXXXXXXXXXX
XXXXXXXXXXXXXXX
XXXXXXXXXXXXXXX
XXXXXXXXXXXXXXX
XXXXp   X  XXXX
XXXX       XXXX
XXXX    X  XXXX
XXXX    XX XXXX
XXX    XXX XXXX
X       XX XXXX
X       XX  XXX
X           XXX
XXXXX   XX  XXX
XXXXXXXXXXXXXXX
XXXXXXXXXXXXXXX