XXXXXXXXX
X  XXXXXX
X  XXXXXX
X  XXXXXX
X  D  XXX
X  Dp XXX
X  XXXXXX
XXXXXXXXX
XXXXXXXXX