XXXXXXXXXX
XXXXXXXXXX
XXXXXXXXXX
X  XX  XXX
X      XXX
X   D XXXX
X  X  XXXX
X     XXXX
XXXXXXXXXX
XXXXXXXXXX