XXXXXXXXXXX
XXXX X   X 
XXXX X  XX 
XXXX     X 
XXX     p  
XXX XX X  X
XX  XXX  XX
XX  XX  XXX
XX  XX  XXX
XX XXXX XXX
XXXXXXXXXXX