XXXXXXXXXX
X  XXXXXXX
X  D   XXX
X  XXX XXX
X    X XXX
X    X XXX
X p X  XXX
X   X  XXX
XXXXXXXXXX
XXXXXXXXXX