XXXXXXXXXXXXXXX
XXXXXXXXXXXXXXX
XXXXXXXXXXXXXXX
XXX  XXXXXXXXXX
XXX  XXXXXX  XX
XXX      XX  XX
XXX      D   XX
XXXXXXX  XX  XX
XXXXXXX  XXX XX
XXXXXXX  XX  XX
X   p        XX
X       p    XX
X        XXXXXX
XXXXXXXXXXXXXXX
XXXXXXXXXXXXXXX