XXXXXXXXXX
XXXXXXXXXX
XXXXXXXXXX
X  XXXXXXX
X  XXXXXXX
XX   XXXXX
XX    XXXX
XX    XXXX
XXXXXXXXXX
XXXXXXXXXX