XXXXXXXXXXX
XXXXXXXXXXX
XX  XXXXXXX
XX       XX
X    XXX XX
X    XX  XX
X     D  XX
X       XXX
XX      XXX
XXXXXXXXXXX
XXXXXXXXXXX