XXXXXXXX
XXXXXXXX
X  X  XX
X  D  XX
X     XX
X    XXX
XXXXXXXX
XXXXXXXX