XXXXXXXXXXXXXXXXX XXX
XXXXXXXXXXXXXXXXXXXXX
XXXXXXXXXXXXXXXXXXXXX
XXXXXXXXXXXXXXXXXXXXX
XXXXXXXXXXXXX XXXXXXX
XXXXXXXXXXXXX   XXXXX
XXXXXXXXXXXXXX   XXXX
XXXXXXXXXXXXXXX  XXXX
XXXX XXXXXXXXXX  XXXX
XXXX XXXXX XXXXX  XXX
XXX  XXXXX XX     XXX
XXX XXXXXX XX X  pXXX
XXX XXXXXX        XXX
XXX  XXX   X  X   XXX
XXXX XXX XXXX X    XX
XXXX XX  XXXX X   XXX
XXX  XX  XXXX  DX XXX
 X  XX   XXXX   X XXX
X  XXX    XXD   X XXX
X XXXX   XXX      XXX
XXXXXXX  XXX      XXX