XXXXXXXXXXXXXXXXXXXX
XXXXXXXXXXXXXXXXXXXX
XXXXXXXXXXXXXXXXXXXX
XXXXXXXXXXXXXXXXXXXX
XXXXXXXXXXXXXXXXXXXX
X     XXXXXXXX  XXXX
X     XXXXXXXX  XXXX
XX X            XXXX
XX       XXXXX  XXXX
XX p  X  X  XX  XXXX
XX       X     XXXXX
XX           XXXXXXX
X             XXXXXX
X             XXXXXX
X         XXXXXXXXXX
X      XXXXXXXXXXXXX
X     XXXXXXXXXXXXXX
XXXXXXXXXXXXXXXXXXXX
XXXXXXXXXXXXXXXXXXXX
XXXXXXXXXXXXXXXXXXXX