XXXXXXXXXXXXXXXXXX
XXXXXXXXXXXXXXXXXX
XXXX  XXXXXXX   XX
XXXX  XXXXXXX   XX
XXX             XX
XXX   XXXXXXX   XX
XXX   XXXXXXXX XXX
XXXD     XXXXX XXX
XX       XXXXX XXX
XX        XXXX XXX
XX        XXXX XXX
XX    p   XXX  XXX
XX        XXX  XXX
X    X  XXXXX  XXX
X     p XXXXXXXXXX
X    XXXXXXXXXXXXX
XXXXXXXXXXXXXXXXXX
XXXXXXXXXXXXXXXXXX