XXXXXXXXXXXXXXXXXXXXXXXX
XXXXXXXXXXXXXXXXXXXXXXXX
X    XXXXXXXXXXXXXXXXXXX
X    XXXXXXXXXXXXXXXXXXX
X    XXXXXXXXXXXXXXXXXXX
X         XXXXXXXXXXXXXX
X    X    XXXXXXXXXXXXXX
X    X    XX  XXXXXXXXXX
XXXD          XXXXXXXXXX
XXX     X XX  XXXXXXXXXX
XXX      D   XXXXXXXXXXX
XXX     X XXXXXXXXX  XXX
XXX                  XXX
XXX     X XXXXXXXXXX  XX
XXX     X X  XXXXXXX  XX
XXX                   XX
XXXXX            XXX  XX
XX       p       XXXX XX
XX               XXXX XX
XXXXX        p   XXXX XX
XXXXX                XXX
XXXXX       XXXXXXXXXXXX
XXXXXXXXXXXXXXXXXXXXXXXX
XXXXXXXXXXXXXXXXXXXXXXXX