XXXXXXXXXXXXXXXXXXX
X    pXXXXXXXXXXXXX
Xp    XXXXXXXXXXXXX
XXX    XXXXXXXXXXXX
XXX        XXXXXXXX
XXX XXXXXX XXXXXXXX
XXX XXXXXX XXXXXXXX
XXX XXXXXXDXXXXXXXX
XXX    XXX XXXXXXXX
XXX     D     XXXXX
XXX    XXX XX XXXXX
XXX X XX    X XXXXX
XXX X       X XXXXX
XXX         X XXXXX
XXXXXXXXX XX   XXXX
XXXXXXXXX      XXXX
XXXXXXXXXXXX   XXXX
XXXXXXXXXXXXXXXXXXX
XXXXXXXXXXXXXXXXXXX