 D XXXXX
XX   XXX
XX   XXX
X  X XXX
X    XXX
XXX  XXX
XXXXXXXX
XXXXXXXX