XXXXXXXXXXXXXXXXXXXXX
XXXXXXXXXXXXXXXXXXXXX
XX    XXXXXXXXXXXXXXX
XX      XXXXXXXXXXXXX
XX    X XXXXXXXXXXXXX
XXXX XX XXXXX     XXX
XXXX XX XXXXX     XXX
XXXX      XXX     XXX
XXXX      XXXXX XXXXX
XXXX           XXXXXX
XXXX      XXXX  XXXXX
X               XXXXX
X        X  X    XXXX
XX    XXXX  X    XXXX
XX p        X    XXXX
XX     XXX  X    XXXX
XX          X    XXXX
XX     XXXXXXXXXXXXXX
XX     XXXXXXXXXXXXXX
XXXXXXXXXXXXXXXXXXXXX
XXXXXXXXXXXXXXXXXXXXX