XXXXXXXXXXXXXXX
XXXXXXXXXXXXXXX
XXX  XXXXXX  XX
XXX  XXXXXX  XX
XXXX         XX
XXXX  XXXXX  XX
XXX   XXXXXX XX
X          X XX
X      X   X XX
X          X XX
X       DX X XX
X      XX  X XX
X    XXXX   XXX
XXXXXXXXXXXXXXX
XXXXXXXXXXXXXXX