XXXXXXXX
XXXX  XX
XXXX  XX
X  X pXX
X     XX
X  D XXX
XXXXXXXX
XXXXXXXX