XXXXXXXXXXXXXXXXXX
XXXXXXXXXXXXXXXXXX
XX    XXXXXXXXXXXX
XXp     XXXXXXXXXX
XXXX XX XXXXXXXXXX
X     X XXXXXXXXXX
X       XXXXXXXXXX
X       XXXXXXXXXX
X       XXXXXXXXXX
X        XX     XX
X        XX     XX
X               XX
X        XXpp   XX
X        D      XX
X   X    XXXXXXXXX
XXXXX    XXXXXXXXX
XXXXXXXXXXXXXXXXXX
XXXXXXXXXXXXXXXXXX