XXXXXXXXXXXXXXXXXXX
XXXXXXXXXXXXXXXXXXX
XX  XXXXXXXXXXXXXXX
XX  XXXXXXXXXXXXXXX
XX         DXXXXXXX
XX  XXXXX   XXXXXXX
XX  XXXXX   X    XX
XX    XXX        XX
XX      X pDX    XX
XXX      X  X    XX
XX   p   X  XXXXXXX
XX     p X DXXXXXXX
XX     p X   XXXXXX
XX            XXXXX
XX            XXXXX
XX      XXXXXXXXXXX
XXX     XXXXXXXXXXX
XXXXXXXXXXXXXXXXXXX
XXXXXXXXXXXXXXXXXXX