XXXXXXXXXXXXXXXXXXXXXXXX
XX   X     XXXXXXXXXXXXX
XX   X       D    DXXXXX
XX      XXXXXXXXXX XXXXX
XX   XXXXXXXXXXXXX XXXXX
XX   XXXXXXXXXXXXX XXXXX
X    XXXXXXXXXXXXX XXXXX
X       X  XXXXXXX XXXXX
X          XXXXXXX XXXXX
X       XXXXXXXXXX XXXXX
X       X  XXXXXXX XXXXX
X          XXXXXXX XXXXX
X       X      XXX XXXXX
X       X      XXX XXXXX
X     D        XXX XXXXX
X              XXX XXXXX
X              XXX XXXXX
XXX   p    X        XXXX
XXX                 XXXX
X                   XXXX
X                   XXXX
XXXXXXXXX   XXXXX   XXXX
XXXXXXXXXXXXXXXXXXXXXXXX
XXXXXXXXXXXXXXXXXXXXXXXX