XXXXXXXXXXXX
XXXXXXXXXXXX
X   XXXXXXXX
X    XXXXXXX
X    XXXXXXX
XX X XXXXXXX
XX    XXXXXX
XX       XXX
XX       XXX
XX       XXX
XXXXXXXXXXXX
XXXXXXXXXXXX