XXXXXXXXXXXXX
X  XXXXXXXXXX
X     XXXXXXX
X  XX XXXXXXX
XX    XXXXXXX
XX    XXXXXXX
X  X pXXXXXXX
X     XXXXXXX
X     D   XXX
X         XXX
X      XXXXXX
XXXXXXXXXXXXX
XXXXXXXXXXXXX