XXXXXXXXXXXXXXXXX
XXXXXXXXXXXXXXXXX
XXXXXXXXXXXXXXXXX
XXXXXXXXXXXXXXXXX
XXX   XXXXXX pXXX
XXX           XXX
XXX  X  XX XX XXX
XX      X   X XXX
XX   X      X XXX
XX   X XX  XX XXX
XX         XX XXX
XX     XX  XX XXX
XX XXX XXX XX XXX
X   X  XXX XX XXX
X            XXXX
XXXXXXXXXXXXXXXXX
XXXXXXXXXXXXXXXXX