XXXXXXXXXXXXXXXXXXXXXX
XXXX         XX XX XXX
XXXXXXX      XX    XXX
XXXXXX  X    XXXD   XX
XXXXXX XX    XXXX XXXX
XXXXXX XX    XXXX XXXX
XXXXX  X     XXXX XXXX
X XX  XX   X XXXX XXXX
X XXX  XX  D XXXX XXXX
X XXXX       XXXX XXXX
X XX    X  X  XXXXXXXX
X  D  XXXX XX XXXXXXXX
XX XX XXX  X  XXXXXXXX
XXXXX X    X  XXXXXXXX
XXXX  XX  XX XXXXXXXXX
XXXX XXX  XXXXXXXXXXXX
XXXX XXXX XXXXXXXXXXXX
XXXX XX   XXXXXXXXXXXX
XXX  X  XXXXXXXXXXXXXX
XXX    XXXXXXXXXXXXXXX
XXXXXXXXXXXXXXXXXXXXXX
XXXXXXXXXXXXXXXXXXXXXX