XXXXXXXXXXXXXXXXXXXXX
XXXXXXXXXXXXXXXXXXXXX
XXXXXXXXXXXXXXXXXXXXX
XXXXXXXXXXX  XXXXXXXX
XXXXXXXXXXXX XXXXXXXX
XX XXXXXXXXX  p XXXXX
XX  XXXXXXXXX  XXXXXX
XXXp  XXXXXXX XXXXXXX
XXX X  XXXXXX XXXXXXX
XX  XX XXXXXX XXXXXXX
X  XXX  XXX X DXXXXX 
X XXXXX DX     XXXXXp
X XXXXX XXXXX  XXXXXX
XXXXXXX    XX  XXXXXX
XXXXXXXXXX   p  XXXXX
XXXDXXXXXX    XXXXXXX
XXX  XXXXX      XXXXX
XXXX XXXXX   XX XXXXX
X     XXXX   XX  XXXX
X XX  XXXX   XXX XXXX
XXXX  XXXX p   X XXXX