XXXXXXXXXXXXXXXXXXXXXX
XXXXXXXXXXXXXXXXXXXXXX
XXXXXXXXXXXXXXXXXXXXXX
XXXX      XXXXXXXXXXXX
XXXX             DXXXX
XXXXXXX XXXXXXXXX XXXX
XX    X XXXXXXXXX XXXX
X     X XXX  XXXX XXXX
X       XXX  XXXX XXXX
X     X XXX  XXXX XXXX
XXX   X XXX  XXXX XXXX
XXX   X XXX  X      XX
XXX      XXX X      XX
XXX                 XX
XXX          X      XX
XXX          X      XX
X    p       XXXXXXXXX
X             XXXXXXXX
X             XXXXXXXX
X             XXXXXXXX
XXXXXXXXXXXXXXXXXXXXXX
XXXXXXXXXXXXXXXXXXXXXX