XXXXXXXXXXXXXXXXXXXXXXXX
XXXXXXXXXXXXXXXXXXXXXXXX
XXXXXXXXXXXXXXXXXXXXXXXX
X  XXXXXXXXXXXXXXXXXXXXX
X  XXXXXXXXXXXXXXXXXXXXX
X                 XXXXXX
X  XXXXXXXXXXXXXX XXXXXX
XX XXXXXXXXX   XX XXXXXX
XX XXXXXXXXX   X  XXXXXX
XX XXXXXXXXX      XXXXXX
XX XXX     D   X  XXXXXX
XX  p     XX   XXXXXXXXX
XX        XX   XXXXXXXXX
XX       pXX   XXXXXXXXX
X         XXXXXXXXXXXXXX
X         XXXXXXXXXXXXXX
X         XXXXXX     XXX
X         XXXXXX     XXX
XX                   XXX
XX          XXXX     XXX
XXX               XXXXXX
XXX    XXXXXXXXXXXXXXXXX
XXXXXXXXXXXXXXXXXXXXXXXX
XXXXXXXXXXXXXXXXXXXXXXXX