XXXXXXXXXXXXXXXXXXXXXX
XXX     X     XX    pX
XXXXX  XX     pXX XXXX
X  XX      XX X    XXX
X   XXX     X   XXXXXX
XXD XXX  XX XX  XXXXXX
X    D   XX     XXXXXX
XX  X XX     X   XXXXX
XX X  XX    XXX  XXXXX
XX X  XX   XXXX XXXXXX
XXXX  XX   XXXX XXXXXX
XXXXX      XXXX  XXXXX
XXXXX      D XXXXXXXXX
XXXXX  X   X   XXXXXXX
XXXXXX XXX    XXXXXXXX
XXXXX  XXX    X       
XXXX pXXXXXXX XXXXXXXX
XXX  XXXXXXXX XXXXXXXX
XXXX   XXXXXX   XXXXXX
XXXXX      XXXXXXXXXXX
XXXXXXXXXXXXXXXXXXXXXX
XXXXXXXXXXXXXXXXXXXXXX