XXXXXXXXXXXXXXXXXX
XXX  XXXXXXXXXXXXX
XXX  XXXXXXXXXXXXX
XXX  XXXXXXXXXXXXX
XXXXDXXXXXXXXXXXXX
XXXX XXXXXXXXXXXXX
XXXX XXXXXXXXXXXXX
X    XXXXXXX    XX
X               XX
XXX  X    XX    XX
XXX       XX    XX
XXX  X    X    XXX
XX             XXX
XX             XXX
XX            XXXX
XX    XXXXXXXXXXXX
XXXXXXXXXXXXXXXXXX
XXXXXXXXXXXXXXXXXX