XXXXXXXXXXXX
XXXXXXXXXXXX
XXXXXXXXXXXX
XXXp XX   XX
XX        XX
XX   XXX XXX
X    XXX XXX
X   X  X XXX
XX  Xp  XXXX
XX     XXXXX
XXXXXXXXXXXX
XXXXXXXXXXXX