XXXXXXXXXXXXXXXXXXXXX
XXXXXXXXXXXXXXXXXXXXX
XXXXXXXXXXXXXXXXXXXXX
XXXXXXXXXXXXXXXXXXXXX
XXXXXXXXXXXXXXXXXXXXX
XX      XXXXXXXXXXXXX
XX      XXXXXXXXXXXXX
XX               XXXX
XX     p  XXXXXX XXXX
XXXX      XXXXXX XXXX
XXXX        XXXX XXXX
XXXX      X XXXX XXXX
XXp           XX XXXX
XX           p     XX
XX            XX X XX
XX    p   XXXXXX X XX
XX        XXX      XX
XX                 XX
XXXXX              XX
XXXXXXXXXXXXXXXXXXXXX
XXXXXXXXXXXXXXXXXXXXX