XXXXXXXXXXXXXXXX
XXXXXXX  XXXXXXX
X    XX  XXXXXXX
X    XXX XXXXXXX
X        XXXXXXX
X    XX  XXX  XX
XXX           XX
XXXXXXX DXXX  XX
XXXXXXX  XXXX XX
XXXX     XXXX XX
XXX      XXXX XX
XXX   X     XDXX
X           DXXX
X           XXXX
XXXXXXXXXXXXXXXX
XXXXXXXXXXXXXXXX