XXXXXXXXXXX
XXXXXXXXXXX
XXXXXXXXXXX
D  XXXXXXXX
XX  XXXXXXX
X  XXXXXXXX
XXXXXXXXXXX
XXXXXX XX X
XXXXX     X
XXXD       
XXX    XXXX