XXXXXXXXXXXXXXXX
XXXX XX  XXX   X
XXXXXX   XXX   X
XXXXXXX XXX    X
XXXXXXXXXXX X  X
 XXXXXXXXXX X   
X XXXXXXXXX   XX
XXXXXXXXXXX  XXX
XXXXXXXX    XXXX
XXXXXXXX  XXXXXX
XXXXXXXXXDXXXXXX
XXXXXXX   XXXXXX
XXXXXXX XXXXXXXX
XXXXXXXXXXXXXXXX
XXXXXXXXXXXXXXXX
XXXXXXXXXXXXXXXX