XXXXXXXXXXXXX
XXXD  XX     
XXXXXX  D XXX
XXXXXDX  XXXX
X            
X XXXX       
XXXXXX  pXXXX
XXXXX   XXXXX
XXX D XXXXXXX
XXXXXXXXXXXXX
XXXXXXD XXXXX
XXX      XXXX
XXXX pXX    X