XXXXXXXXXXXXXXXXXXXXXXX
XXXXX  XXX  X   p XXXXX
XXXXX   XXX  p XX XXXXX
XXXXX X XXXX   XX XXXXX
XXXX     XXX D XXXXXXXX
XXX    X XXXD  XXXXXXXX
XXX XXXX XX    XXXXXXXX
XXX XXXX  X      XXXXXX
XXX      X  X XX   XXXX
XXXXX      XX XXXX XXXX
X   X  p XXX  XXXX XXXX
 XX XX  XXXX XXXXX  XXX
XXXXXXX  XXX XXXXXX XXX
XXXXXXXX XXX  XXXXX XXX
XXXXXXX DXXXD XXXXX   X
XXXXXX  XXXX    XXXX  X
XXXXXX XXXXXX    XXXXXX
XXXXXX  XXXXX XXXXXXXXX
XXXX   XXXXXX XXXXXXXXX
 XXXXXXXXXXXX XXXXXXXXX
XXXXXXXXXXX   XXXXXXXXX
XXXXXXXXXXXX XXXXXXXXXX
XXXXXXXXXXX  XXXXXXXXXX