XXXXXXXXXXXXXXXXXXXXXXX
XXXXXXXXXXXXXXXXXXXXXXX
XX  XXXXXXXXXXXXXXXXXXX
XX  X      XXXXXXXXXXXX
XX          XXXXXXXXXXX
XX  X       XXXXXXXXXXX
XX  XXX  XX XXXXXXXXXXX
XXXXXXX  XX XXXXXXXXXXX
XXXXXXX  XX XXXXXXXXXXX
XXXXXXX  XX XXXXXXXXXXX
XXXX     XX XX    XXXXX
XX        X XX    XXXXX
XX        X XX    XXXXX
XX        XDXX    XXXXX
XXXX              XXXXX
XXXX     pX XX    XXXXX
XXXX      X XXXXXXXXXXX
XXXX          XXXXXXXXX
XXXX          XXXXXXXXX
XXXX          XXXXXXXXX
XXXX          XXXXXXXXX
XXXXXXXXXXXXXXXXXXXXXXX
XXXXXXXXXXXXXXXXXXXXXXX