XXXXXXXX
XX X X  
X       
XXXX  XX
XXXXX XX
XXXX  X 
XXXX  X 
XXXX XXX