XXXXXXXXXXXXXXX
XXXXXXXXXXXXXXX
XXXXXXXXXXXXXXX
XXXXXXXXXXXXXXX
X  XXXX   XXXXX
X  X pXp  XXXXX
X  X  X   XXXXX
X  X  X   XXXXX
XX    XX XXXXXX
X        X   XX
X        X   XX
X   XXXX     XX
X            XX
XXXXXXXXXXXXXXX
XXXXXXXXXXXXXXX