XXXXXXXXX
XX  XXXXX
XX  XXXXX
XXX   XXX
X     XXX
X    XXXX
X  XXXXXX
XXXXXXXXX
XXXXXXXXX