XXXXXXXX
XXXXXXXX
XXX  XXX
XXX  XXX
X  X  XX
X     XX
XXXXXXXX
XXXXXXXX