XXXXXXXXXXX
XXXXXXXXXXX
X  XXXXXXXX
X  XXXXXXXX
XX  XXXXXXX
XX  XXXXXXX
X     X  XX
X     D  XX
XX    D XXX
XXXXXXXXXXX
XXXXXXXXXXX