XXXXXXXXXXXXXXX
XXXXXXXXXXXXXXX
X  XXXXXXXXXXXX
X  XXXXXXXXXXXX
X          XXXX
X  XXXXXXX XXXX
XX XXXXXXX XXXX
X      XX  XXXX
X      XX  XXXX
X        XXXXXX
X            XX
X            XX
XX           XX
XXXXXXXXXXXXXXX
XXXXXXXXXXXXXXX