XXXXXXXXXXXXXXXXXXXXX
XXXXXXXXXXXXXXXXXXXXX
X   XXXXXXXXXXXXXXXXX
X           XXXXXXXXX
X   XXXXXXX XXXXXXXXX
XX XXXXXXXX XXXXXXXXX
XX XXXXXXXX XXXX  XXX
XX X D            XXX
XX X XXXXXX XXXXX XXX
XX X    XXX XXXXX XXX
XX      X    XXXX XXX
XX           XXXX XXX
XX           XXXX XXX
X        p        XXX
X            XX  pXXX
X     XX      X   XXX
X        p    X   XXX
XXXXXXXXXXXXXXXXXXXXX
XXXXXXXXXXXXXXXXXXXXX
XXXXXXXXXXXXXXXXXXXXX
XXXXXXXXXXXXXXXXXXXXX