XXXXXXXXXX
XXXXXXXXXX
XX  XXXXXX
XX  XXXXXX
XXX XXXXXX
XXX X  XXX
X      XXX
X     XXXX
XXXXXXXXXX
XXXXXXXXXX