XXXXXXXXXXXXX
X  XXXXXXXXXX
X  XXXX p XXX
X         XXX
XX    Xp  XXX
X     XX XXXX
X        XXXX
X   XXX  XXXX
XX  XX   XXXX
XX  XX   XXXX
XXXXXX   XXXX
XXXXXXXXXXXXX
XXXXXXXXXXXXX