XXXXXXXXXXXXXXXX
XXXXXXXXXXXXXXXX
XXXXXXXXXXXXXXXX
XXXXXXXXXXXXXXXX
XX    XX  XXXXXX
XX     X  XXXXXX
XX     X  XXXXXX
XXXX X XX XXXXXX
XXXX X XX XXXXXX
XXX    XX XXXXXX
XXX      XXXXXXX
XXX    XXXX   XX
XXXX    D     XX
XXXXXXXXXXX   XX
XXXXXXXXXXXXXXXX
XXXXXXXXXXXXXXXX