XXXXXXXXX
XXXXXXXXX
XX  XXXXX
XX  XXXXX
X   X  XX
X  p   XX
X  pXXXXX
XXXXXXXXX
XXXXXXXXX