XXX XXXXXXXX
XXX D XXXXXX
XXXXXXXXXXXX
XXXXXXXXXXXX
XXXXXXXXX   
XXXXXXXX    
XXXXX  X XXX
XX   p D XXX
XX          
XXXXXXXXXX  
XXXXXXXXXXXX
XXXXXXXXXXXX