XXX XXXXXXXXXXXXXXXX
XX     XX   X   XXX 
XX XXX  X   X   X D 
XXXXXXXXX       X XX
XXXXXXX    X   X  XX
XXXXXXX XX   X X XXX
XXXXXXX XX  XXXX XXX
XXXXXX  XX  XXXX   X
XXXXXXX XX  XXXXXX X
XXXX    XX     XX  X
XXXXXXXXXXX  X pX D 
XXXXXXXXXXXX XX XXX 
X    XXXXXXXD   XXXX
XXXX XXXXXXXXXX XXXX
XX   XXXXXXXXX  XXXX
XXXX XXXXXXXXXD XXXX
XXXX  XXXXXXXXX XXXX
XXXX XXXXXXXXXX XXXX
XXXX  XXXXXXXXXXXXXX
XXXXXXXXXXXXXXXXXXXX