XXXXXXXXXXXXXXXXXXX
XXXXXXXXXXXXXXXXXXX
XXXX  XXXXXXXXXXXXX
XXX   XX   XXXXXXXX
XXX X      XXXXXXXX
X   XXXX   XXXXXXXX
X      XX XXXXXXXXX
XX p   XXDXXXXXXXXX
X      XX XXXXXXXXX
X        XXXXXXXXXX
X    p DD      XXXX
X      XX XXXX XXXX
X           XX XXXX
XX X        XX XXXX
XX X        X   XXX
XX              XXX
XXXXp    XXXX   XXX
XXXXXXXXXXXXXXXXXXX
XXXXXXXXXXXXXXXXXXX