XXXXXXXXXXXXXXXXXXXXXX
XXXXXXXXXXXXXXXXXXXXXX
XXXXXXXXXXXXXXXXXXXXXX
XXXXXXXXXXXXXXXXXXXXXX
X      XXXXXXXXXXXXXXX
X          XXXXXXXXXXX
XXXX XXXX  XXXXXXXXXXX
XXXX       XXXXXXXXXXX
XXXX  XXX  XXXXXXXXXXX
XXXX  XXXXXXXXXXXX  XX
XXXX DXXXXXX   XXX  XX
XXXX      X         XX
X         X         XX
X         XD   XXX  XX
X                 XXXX
X            XXXX XXXX
X         X XX      XX
XXXX                XX
XXXXXXXXXX  XX      XX
XXXXXXXXXX  XXXXXXXXXX
XXXXXXXXXXXXXXXXXXXXXX
XXXXXXXXXXXXXXXXXXXXXX