XXXX XXXXXXXX
XXXX  XXX  XX
XXXp XXX   XX
XXX  XXXXX  X
XX    X D  XX
XXX    DXXX  
XXX  X  XXX  
XXX  X XXXX  
XXX   XXXX  X
XXX    XXXXXX
XXX   XXXXXXX
XXX   XXXXXXX
XXXXXXXXXXXXX