XXXXXXXXXXXXX
XXXXXXXXXXXXX
XXXX  XXXXXXX
XXXX  XXXXXXX
XXXX XXXXXXXX
XXXX X XXXX X
XXXX   XXXX X
XXXX   XXXX X
XXXX      X X
XXXX XXX  X  
XXX  XX      
    DXXX   XX
X  X XXX X  X