XXXXXXXXX
XXXX  XXX
XX    XXX
X  XX  XX
Xp XX  XX
X      XX
X  pp XXX
XXXXXXXXX
XXXXXXXXX