XXXXXXXXXXXXXXXXXXXX
XXXXXXXXXXXXXXXXXXXX
XXXXXXXXXXXXXXXXXXXX
XXXXXXXXXXXXXXXXXXXX
XXXXXX     XXXXXXXXX
XXXXXX     XXXXXXXXX
XXXXXX     XXXXXXXXX
XXXXXX     XXXXXXXXX
X  XXX     XXXXXXXXX
X       XXXXXXXXXXXX
X   XX   XXXXXXXXXXX
X        XXXXXXXXXXX
X     p    XXXXXXXXX
X          XXXXXXXXX
XXX           XXXXXX
XXXX           XXXXX
XXX            XXXXX
XXX    XXXXXXXXXXXXX
XXXXXXXXXXXXXXXXXXXX
XXXXXXXXXXXXXXXXXXXX