XXXXXXXXXXXXXXXXXXXXX
X    XXXXXXX   XXXXXX
X    XXXXXXX   XXXXXX
X    XXXXXXX   XXXXXX
XXX XXXXXXXXX XXXXXXX
X     XXXXXXX XXXXXXX
X        XXXXDXXXXXXX
X        XXXX XXXXXXX
X                XXXX
XX  X    X     X XXXX
X   X    X     X XXXX
X       XX     X XXXX
X        X     X XXXX
X p      X     XDXXXX
X                 XXX
X                 XXX
X              XXXXXX
XXX        p   XXXXXX
XXXXXXXXXXXXXXXXXXXXX
XXXXXXXXXXXXXXXXXXXXX
XXXXXXXXXXXXXXXXXXXXX