XXXXXXXXXXXXXXXXXXXXXXXX
XXXXXXXXXXXXXXXXXXXXXXXX
XXXXXXXXXXXXXXXXXXXXXXXX
XX   p  XXXXXXXXXXXXXXXX
XX              XXXXXXXX
XX      XXXXXXX XXXXXXXX
XXXXX XXXXXXXXX XXXXXXXX
XX     XXXXXXXX XXXXXXXX
XX     XXXXXXXX XXXXXXXX
XX         XXXX XXXXXXXX
XX   p        X XXXXXXXX
X             X XXXXXXXX
X            XX XXXX  XX
X            XX XXXX  XX
X            X   XXX  XX
XX                    XX
XX           X   XXX  XX
XX              p     XX
XX       XXXXX   XXX  XX
XX   X   XXXXX   XXXXXXX
XX  XX   XXXXX   XXXXXXX
XX  XX   XXXXXXXXXXXXXXX
XXXXXXXXXXXXXXXXXXXXXXXX
XXXXXXXXXXXXXXXXXXXXXXXX