XXXXXXXXXXXXXXXX
XXXXXXXXXXXXXXXX
XXXXXX    XXXXXX
XXXXXX       XXX
XXXXXX p  XX XXX
XX   XXX XXX XXX
XX      XXXX XXX
X    XXXXXXX XXX
X    XX  XXX XXX
Xp       XXX XXX
X     XXXXXX XXX
X      XXXXX XXX
X        XX   XX
XX       XX   XX
XXXXXXXXXXXXXXXX
XXXXXXXXXXXXXXXX