XXXXXXXXXX
XXXXX     
XXXXX  DX 
XXXX  X   
X     XXXX
XXXXXXXXXX
XXXXXXXXXX
XXXXXXXXXX
XXXXXXXXXX
XXXXXXX   