XXXXXXXXXXXXXXXXXXXX
XX     X    XXXXXXXX
XX          XXXXXXXX
XX X  XX    XXXXXXXX
X p   XXXX XXXXXXXXX
X       XX XXXXXXXXX
X          XXXXXXXXX
X     XXX  XXXXXXXXX
X     X     XXXXXXXX
X     X  p  XXXXXXXX
X     X      XXXXXXX
XX XXDX      XXXXXXX
XX XX X      XXXXXXX
XX      XX X XXXXXXX
XX      XX    XXXXXX
XX      XX    XXXXXX
XX      XXXXXXXXXXXX
XXX     XXXXXXXXXXXX
XXXXXXXXXXXXXXXXXXXX
XXXXXXXXXXXXXXXXXXXX