XXXXXXXXXXXXXXXXXXXXXXXX
XXXXXXXXX  XXXXXXXXXXXXX
XXXXXXXXX  XXXXXXXXXXXXX
XXXX      pXXXXXXXXXXXXX
XXXX XXXX  XXXXXXXXXXXXX
XXXXDXXXX  XXXXXXXXXXXXX
XXXX    XX XXXXXXXXXXXXX
XXXX          XXXXXXXXXX
XX      XX XX       XXXX
XX                  XXXX
XX  p   X        XXXXXXX
XX      X p   p  XXXXXXX
XXXX X           XXXXXXX
XXXX X  X            XXX
XXXX X  XX X  XX     XXX
XXXX        X XX     XXX
X        X    D      XXX
X          XX XX     XXX
XX         XX XX     XXX
XX               XX XXXX
XXXX  p            XXXXX
XXXXXXXXXXX      XXXXXXX
XXXXXXXXXXXXXXXXXXXXXXXX
XXXXXXXXXXXXXXXXXXXXXXXX