XXXXXXXXXXXXXXXXXXXX
XXXXXXXXXXXXXXXXXXXX
XXXXXXXXXXXXXXXXXXXX
XXXXXXXXXXXXXXXXXXXX
XXXXXXXXXXXXXXXX  XX
XXXXXXX   XXXXXX  XX
X    XX           XX
X         XXXXXXp XX
X    XX   XXXXXXX XX
X     X  pXXXXXXX XX
X         XXXXXXXDXX
X         XXXXXXX XX
XX        XXXXXXX XX
X             pXX XX
X      p       XX XX
X              XX XX
X     XX         XXX
XXXXXXXX     XXXXXXX
XXXXXXXXXXXXXXXXXXXX
XXXXXXXXXXXXXXXXXXXX