 XXXXXXXXXXXXXX
XD X XXX XXX DX
X      X   D XX
XXXXX     XXXXX
XXXXX  X pXXXXX
XXXX  XX XXXXXX
XXXX  XX  XXXXX
XXXX   pX XXXXX
XXX   D X XXXXX
XXX   X X  XXXX
XXXX  X XX XXXX
XXXX       XXXX
XXX DXXXX XXXXX
XXXXXXXXXXXXXXX
XXXXXXXXXXXXXXX