 XXXXXXXXX
XXXXXXXXXX
XXXXXXXXXX
XXXX  XXXX
XXXX XXXXX
XXX  XXXXX
X     XXXX
X  XX XXXX
X  XX XXXX
X D   XXXX