XXXXXXXXX
XXXXXXXXX
XX  XXXXX
XX     XX
X   X  XX
X   X  XX
XXXXX  XX
XXXXXXXXX
XXXXXXXXX