XXXXXXXXXXXXXXXXXX
XXXX    XXXXXXXXXX
XXX     XXXXXXXXXX
XXX XX XXXXXXXXXXX
XXX XX XXXXXXXXXXX
XXX XX XXXXXXXXXXX
XXX XXDXXXX     XX
XXX XX XXXX     XX
X   X     X     XX
X   D     X     XX
X         XXXDXXXX
X       pXXXX XXXX
X       XXXXX XXXX
X   p        XXXXX
X          XXXXXXX
XXXXX      XXXXXXX
XXXXXXXXXXXXXXXXXX
XXXXXXXXXXXXXXXXXX