XXXXXXXXXXXXXXXXXXXXXXX
XXXXXXXXXXXXXXX   XXXXX
XXXXXX            XXXXX
XXXXXXDXXXXXXXXX XXXXXX
XXXXXX XXXXXXXXX XXXXXX
XXXXXX XXXXXXXXX XXXXXX
XXXXXX X  XXXXXX XXXXXX
XX              XXXXXXX
XX      X XXXXXXXXXXXXX
XX      X XXXXXXXXXXXXX
XXXXX     XXXXXXXXXXXXX
XX       pXXXXXXXXXXXXX
XX        XXXXXXXXXXXXX
XX      X   XXX   XXXXX
XX      X   XXX   XXXXX
XXX         D     XXXXX
XXX     XX   XX   XXXXX
XXX     X         XXXXX
XXX     X      XXXXXXXX
XXX     XXXXXXXXXXXXXXX
XXXX    XXXXXXXXXXXXXXX
XXXXXXXXXXXXXXXXXXXXXXX
XXXXXXXXXXXXXXXXXXXXXXX