XXXXXXXXX
XXXXX  XX
XXXXX    
XXXXXX XX
X XXXX   
X XXXD XX
XXXX  XXX
XXX   XXX
XX  XXXXX