XXXXXXXXX
XXXX     
XXX  XD  
XXX XX  D
XXXXXX  X
XXXXX   X
XXXXXXXXX
XXXXXXXXX
XXXXXXXXX