XXXXXXXXXXXXXXXX
XXXXXXXXXXXXXXXX
XXXXXXXXXXXXXXXX
XXXXXXX   XXXXXX
XXXXXXX   XXXXXX
XXXXXXXX XXXXXXX
X  XX  X XXXXXXX
X            XXX
X  XX  X XXX  XX
XXXXXX X      XX
XXX    XXXXX  XX
XXX      XXX  XX
XXX           XX
XXXXX         XX
XXXXXXXXXXXXXXXX
XXXXXXXXXXXXXXXX