XXXXXXXXXXX XXXXX
XXXXXXXXXXXXXXXXX
XXXXXXXXXXXXXXXXX
XXXXXXXXXXXXXXXXX
XXXXXXX    XX  X 
XXXXXXX          
XXXXXXXXX      p 
XXXXX    X       
XXXXX XX         
XXXXp XXX  D XXXX
XXXXXXXXXXXXXXXXX
XXXXXXXXXXXXXXXXX
XXXXXXXXXXXXXXXXX
XXXXX  XXXX  XXXX
XXXX  D      XXXX
XXXXXXXXXXXX   XX
XXXXXXXXXXXXXX   