XXXXXXXXXXXXXXXXXXXXXXXX
XXXXX XX    X    XDXXXX 
X XXX XXX D   XXXX XXXX 
X  DX XXX   X XXX   XXXX
XXXXX XXXD  X  XX XXXXXX
XXXXXD X   XXX X    XXXX
X XX   X   XXXXXXX  XXXX
X    XXXX  XXXXXXXX XXXX
XXX   XXXX  XXXXXXXDXXXX
XXXXX XXXX   p XX   XXXX
XXXX  XXXXXXX XX  XXXXXX
X  X XXXXXXXX XXXXXXXXXX
XX XXXXXXXXXX XXXXXXXXXX
X  XXXXXXXXXX XXXXXXXXXX
XX XXXXXXXXXX  XXXXXXXXX
XXXXXXXXXXXXXX   XXXXXXX
XXXXXXXXXXXXXXX  XXXXXXX
XXXXXXXXXXXXXXX XXXXXXXX
XXXXXXXXXXXXXXX XXXXXXXX
X XXXXXXXXXXXXXXXXXXXXXX
X   XXXXXXXXXXXXXXXXXXXX
XXX  XXXXXXXXXXXXXXXXXXX
XXX  XXXXXXXXXXXXXXXXXXX
XXXX XXXXXXXXXXXXXXXXXXX