XXXXXXXX
XXXXXXXX
XXXXXXXX
Xp XXXXX
X  p XXX
XXX  XXX
XXXXXXXX
XXXXXXXX