XXXXXXXXXXXXXXXXXXXXXXXX
XXXXXXXXXXXXXX   XXXXXXX
XXXXXXXXXX     XXXXXXXXX
XXXXXXXXXX XX  XXXXXXXXX
XXXXXXXXX  XXXXXXXXXXXXX
XXXXXXXXXXXXXXXXXXXXXXXX
XXXXXXXXXXXXXXXXXXXX   X
XXXXXXXXXXXXXXXXX    X  
XXXXXXXXXXXXXXXXXX  XXXX
XXXXXXXXXXXXXXXX    X   
XXXXXXXXX XXXXXX X    XX
XXXXXXXXX p  p       XXX
XXXXXXXXX  XXXX X  X    
XXXXX  D  XX    XX X    
XXXXXXX  XXX XX  X XXX  
XXXXXX   XXX X          
XXXX           XX       
XXX  X X      XXXX  XXXX
XX DX  X  XXX D XX XXXXX
X  XX XXXXXXX    X X    
X XXXXXXXXXX  XX     X  
XXXXXXXXXXXX XXXXXpXXXXX
XXXXXXXXXX   XXXXX XXXXX
XXXXXXXXXXXX  XXXX XXXX 