XXXXXXXXX
X  XXXXXX
X pXXXXXX
XX XXXXXX
X  XXXXXX
X   X pXX
XX     XX
XXXXXXXXX
XXXXXXXXX