XX XXXXXXXXXXXXXXX 
XX XXXXXXXX X  X  X
XXXXXXXXXXX    X  X
XXXXXXXXXXX XX X   
XXXXXXX X  XXX   XX
XXXXXXX D  XX    XX
XXXXXXXXXX  p  XXXX
XXXXXXXXX D    XXXX
XXXXXXX         XXX
XXXXXXX XXXXXXX   X
XXXXXXX XXXXXXXp   
XXXXXXXXXXXXXXXX   
XXXXXXXXXXXXXXXXXXX
XXXXXXXXXXXXXXXXXXX
XXXXXXXXXXXXXXXX XX
XXXXXXXXXXXXXXXX   
XXXXXXXXXXX     DX 
XXXXXXXXXXXXXXXXXX 
XXXXXX  XXXXXXXXXXX