XXXXXXXXXXXXXXXXXXXXX
XXXXXXXXXXXXXXXXXXXXX
XXXXXXXXXXXXXXXXXXXXX
XXXXXX      XXXXXXXXX
XXXXXX      XXXXXXXXX
XXXXXX      XXXXXXXXX
XXX  X      XXXXXXXXX
XXX  X      XXXXXXXXX
XXX  XXXX XXXXXXXXXXX
X         XXXXXXXXXXX
X            XXXXXXXX
X   pXX     p  XXXXXX
X  X         XDXXXXXX
X            X XXXXXX
X  p         X XXXXXX
X            X XXXXXX
XXXX         XDXXXXXX
XXXXXX          XXXXX
XXXXXXX p       XXXXX
XXXXXXXXXXXXXXXXXXXXX
XXXXXXXXXXXXXXXXXXXXX