XXXXXXXXXXXXXXX
XXXXXX   XXXXXX
XXXXXX     XXXX
XXXXXX  pXDXXXX
X    XX XX XXXX
X       XX XXXX
XXX X    XDXXXX
XXX X    X XXXX
XXX X    X XXXX
X        X XXXX
X    XXXX   XXX
X    XXXX   XXX
XXXXXXXXXXXXXXX
XXXXXXXXXXXXXXX
XXXXXXXXXXXXXXX