XXXXXXXXXX
XXXXXXXXXX
XXXXXXXXXX
X  XXXXXXX
X  X  XXXX
X     XXXX
X pXXXXXXX
XXXXXXXXXX
XXXXXXXXXX
XXXXXXXXXX