XXXXXXXXXXXX
XXXXXXXXXXXX
XXX  XXX  XX
XXX    D  XX
XXXX   XXXXX
X  X   XXXXX
X   XX  XXXX
X      pXXXX
X         XX
XX        XX
XXXXXXXXXXXX
XXXXXXXXXXXX