XXXXXXXXXXXXXX
XXXXXXXXXXXXXX
XXXXXXXXX   XX
XXXXXXXXX   XX
XXX   XXXX XXX
XXX        XXX
X  X XXXXX XXX
X       XX XXX
X  X XX X  XXX
XX   XX X  XXX
XX      X  XXX
XX     pXXXXXX
XXXXXXXXXXXXXX
XXXXXXXXXXXXXX