XXXXXXXXXXXXXXXXXXXXXXXX
XXXXXXXXXXXXXX  XXXXXXXX
XXXXXXXXXXXX    XXXXXXXX
XXX XXXX    DX XXXXXXXXX
XXX XXXX  XXXX XXXXXXXXX
XXX XXXX XXXXXXXXX      
XXX XXXXXXXXXXXXXX   XXX
XXXDXXXXXXXXXXXXXXXXXXXX
XXX XXXXXXXXXXXXXXXXXXXX
XXX XXXXXXXX  XXXXXXXXXX
XXX XXXX D       XX pXX 
XXX XXXX XXXXXXX     D p
XXX X    XXXXXX      XXX
XXXpXXXXXXXXXX  XXX     
XXX X          p    XXXX
XXX XX    X  X  XXX XXXX
XXX XXXX  XX   XXXX X   
XXX XXXXX XX   XXXX     
XXX XXXXXX   X XXXX     
XXXDXXXX   XXX  D     X 
XXX XXXX XXXXXXX   DXXX 
XXX XXX  X  XXXXX   XXX 
XXX            XD X  XX 
XXX X   XXXXXX  pXXX XX 