XXXXXXXXXXXXX
XXXXXXXXXXXXX
XXXXX   XXXXX
XXXXX   XXXXX
XXXXX   X  XX
XXXX       XX
XX    XXXX XX
X         XXX
X   XXXXXXXXX
X  XXXXXXXXXX
XXXXXXXXXXXXX
XXXXXXXXXXXXX
XXXXXXXXXXXXX