XXXXXXXXXXX
XXXXX  XXXX
XXX    XXXX
XXX XXXXXXX
XX  XXXXXXX
XX  XXXXXXX
XX  XXXXXXX
XX  XXXXXXX
XXXXXXXXXXX
XXXXXXXXXXX
XXXXXXXXXXX