XXXXXX XXXXXXXXXXXXXXXX
XXXXXX  XXXXXXXXXXXXX  
XXXXXXX    XXXXXXXXXX  
XXXXXXX  X  XXXXXXXXXX 
XXXXXXXXXXX   XXX      
 XXXXXXXXXXX  XXXXXXXXX
XXXXXXXXXXXXX  XXXXXXXX
XXXXXXXXXXXXXX  XXXXX  
XXXXXXXXXXXXXXX       X
XXXXXXXXXXXXXXXXXXXX   
XXXXXXXXXXXXXXXXXXX    
XXXXXXXXXXXXXXXXXX     
XXXXXXXXXXXXXXXXXXXXXXX
XXXXXXXXXXXXXXXXXXXXXXX
XXXXXXXXXXXX   XXXXXXX 
XXXXXXXXXX   X   XXX   
XXXX XXXXX XXXXX      X
XXXX       XXXXXXXX X  
XXXXXXXX     XX   XX  X
XXXXXXXXXXXX           
XXXXXXXXXXXXXXXX XXXXX 
XXXXXXXXXXX     XXX    
XXXXXXXX    XX      XXX