XXXXXXXXXXXXXXXXXX
XXXXXXXXXXXXXXXXXX
XXXXXXXXXXXXXXXXXX
XXXXXXXXXXXXXXXXXX
X     XXXXXXX   XX
X               XX
X        XXXXX XXX
X        XXXXX XXX
XXX      X     XXX
X   XXX  X     XXX
X        X     XXX
X        XXX  XXXX
X             XXXX
X             XXXX
XXXX      D  XXXXX
XXXX    XXXXXXXXXX
XXXXXXXXXXXXXXXXXX
XXXXXXXXXXXXXXXXXX