XXXXXXXXXXXXXXXXXXXXXXXX
XXXXXXXXXXX   XX  XXXXX 
XXXXXXXXXXX   p  X  XXX 
XXXXXXXXXXX XXXXXX   D p
X     X XX  XX XXX      
XXXXX    X  XX  D       
XXXXXXXX D      X   XX  
XXX   D  pD     p X     
XXXXXXX  X   X X       X
XXXXXX   D  pX   XX XX X
XXXX   X        XXX XXXX
XXXX XXX XXX p          
XXXXXXX  XXXXX X  XX XXX
XXXX X  XXXXXX XXXXX XXX
XXX D  XXXXXXX XXXXX XXX
X   XXXXXXXXXX XXXX  XXX
X  XXXXXXXXXXX XXXXXXXXX
XXXXXXXXXXXXXX XXXXXXXXX
XXXXXXXXXXXXXX XXXXXXXXX
XXXXXXXXXXXXXX XXXXXXXXX
XXXXXXXXXXXXXXpXXXXXXXXX
XXXXXXXXXXXXXX XXXXXXXXX
XXXXXXXXXXXXXX XXX XXXXX
XXXXXXXXXXXXXX XXX      