XXXXXXXXXXXXXXX
XXXXXXXXXXXXXXX
XXXXXXXXXXXXXXX
X    XXXXXXXXXX
X        XXXXXX
XXX pXXX XXXXXX
XXX  XXX XXXXXX
XXX  XXX XXXXXX
XX    XX XXXXXX
XX p  X   XXXXX
XX    X   XXXXX
XXX       XXXXX
XXX       XXXXX
XXXXXXXXXXXXXXX
XXXXXXXXXXXXXXX