XXXXXXXXXXXXXX
XXXXXXXXXXXX X
XXXXXXXXXXXX  
XXXXXXXXXXXXX 
XX  XXXXXXXXXX
XXX XXXXXXXXXX
XXX X   XXXXXX
XXX     XXXXXX
XXXXX   XXXXXX
XXXXX    D D  
XXXXX  D      
XXXXX  X  XXXX
XXXX  XXX  XXX
XXp   XXX  XXX