XXXXXXXXXXXXXXX
XXXXXXXXXXXXXXX
XXXXXXXXX   XXX
XXXXXXXXX   XXX
XX    XXX   XXX
XX          XXX
XX    X    XXXX
X          XXXX
X     X    XXXX
X       D XXXXX
X   p       XXX
X           XXX
XXXXXXXXXXp XXX
XXXXXXXXXXXXXXX
XXXXXXXXXXXXXXX