XXXXXXXXXXXXXXXXXXXX
XXXXXXXXXXXXXXXXXXXX
X   XXXXXXXXXXXXXXXX
X    XXXXXXXXXXXXXXX
X    XXX   XXXXXXXXX
XXXX XXX   XXXXXXXXX
XXXX pXX   XXXXXXXXX
XXXX  XX   XXXXXXXXX
XX     X   XXXXXXXXX
XX       X XXXXXXXXX
XXXX  XXXX XX    XXX
XXXX             XXX
XXX    XXX XX    XXX
XX         XXXX XXXX
XX      p  XXXX XXXX
XXXXXXXXX   XXX XXXX
XXXXXXXXX p    XXXXX
XXXXXXXXX   XXXXXXXX
XXXXXXXXXXXXXXXXXXXX
XXXXXXXXXXXXXXXXXXXX