XXXXXXXXXXXX
XXXXXXXXXXXX
XX   XXXXXXX
XX  pXXX  XX
XX   X    XX
XX  XX X  XX
X    X XX XX
X        pXX
XXX       XX
XXXXX  XXXXX
XXXXXXXXXXXX
XXXXXXXXXXXX