XXXXXXXXXXXXXXXXXXXX
XXXXXXXXXXXXXXXXXXXX
XX  XXXXXXXXXXXXXXXX
XX  XXXXXXXXXXXXXXXX
XX  XXXXXXXXXXXXXXXX
XX  XXXXXXXXXXXXXXXX
XXX XXXXXXX    XXXXX
XXX X    XX    XXXXX
XXX  p         XXXXX
XXX      XX    XXXXX
XXX  XXXXXXXX XXXXXX
XXXD XXXX  XX XXXXXX
XXX  XXXX  XX XXXXXX
XXX  X  X  XX XX  XX
XX     p      XX  XX
XX                XX
XX                XX
XX    XXXXX   XX  XX
XXXXXXXXXXXXXXXXXXXX
XXXXXXXXXXXXXXXXXXXX