XXXXXXXX
XXXX  XX
X     XX
X  XX XX
Xp X  XX
X     XX
XXXXXXXX
XXXXXXXX