XXXXXXXXXXXXX
XXXXXXXXXXXXX
X  XXXXXXXXXX
X  XXXXXXXXXX
X  XXXXXXXXXX
XX  X  X   XX
XX         XX
XX  XXDX   XX
XX   X XXDXXX
XX       XXXX
XX     XXXXXX
XXXXXXXXXXXXX
XXXXXXXXXXXXX