XXXXXXXXXXXXXXXXX XXXX
XXXXXXXXXXXXXXXXXXXX X
XXXXXXXXXXXX XXXXXXX  
XX  XXXXXXXX XXXXXXXXX
XXX XXXXXXXX XXXXXXXXX
XXX XXXXXXXX XXXXXXXXX
XX  XXXXXXXX XXXXXXXXX
XX D  XXXXXX XXX   XXX
XX XX XXXXXX X   XXXXp
XD X  XXXXXX    XXXXXX
X    XXXXXXXXX  XXXXXX
X   XXXXXXXXXX   XXXXX
X XDXXXXXXXXX    XXXXX
XXX XXXXX      X  XXXX
XXX  XXX  XXXX p XXXXX
XXXX XXXX XXXX   XXXXX
XXXX X  X XX   X  XXXX
XXX  XXD p   XXX   XXX
XXX XXX    XXXXXX   XX
XXX  X    XXXXXXXXXpXX
XXX       XXXXXXXXX XX
XXXX    X  XXXXXXXX XX