XXXXXXX XXXXXXXXXXXXX
XXXXXXXXXXXXXXXXXXXXX
XXXXXXXXXXXXXXXXXXXXX
XXXXX  XXXXX XXXX X  
XXXXXX               
XXXXXX    XX   X  X  
XXX     X X    XX XXX
X   X    X    p   XXX
XXXXXXX        DX XXX
XXXXXD  X   X     XXX
XXXXXp     XXXXXX    
XXX   XXXX XXXXXXXX  
XX  XXXXXXXXXXXXXXXXX
XXXXXXXXXXXXXXXXXX XX
XXXXXXXXXXX         D
XXXXXXX  XX XX       
XXXXXXXX         XXXX
XXXXX  XXXX XXXX XXXX
XXX         XXXXXXXXX
XXX XXXX  X XXXXXXXXX
XXXXXXXXXXXXXXXXXXXX 