XXXXXXXXXXXXXXXXXXXXXXX
XXXXXXXXXXXXX XXXXXXXXX
XXXXXXXXXXXX       XX X
XXXXXXXXXXXXX XX       
XXXXXXXXX     XX p XX  
XXXXXXXXX XX XX    XXXX
XXXXXXXXXXX    p    XXX
 XXXXXXXXXXX XXXXXXp   
XXXXXXXXXXXXXXXXXXXXX  
XXXXXXXXXXXXXXXXX p  XX
XXXXXXXXXXXXXXXXX XX   
XXXXXXXXXXXXXXXXXXXX XX
XXXXXXXXXXXXXXXXXXXXXXX
XXXXXXXXXX     XXXXXXXX
XXXXXXXXX  X     XXXXXX
XXXXXX    X X  X XXXXXX
XXXX   XXD           p 
XXXXXXXXXX  XX  X      
XXXXXXXXXXXXXXXXXXXX   
XXXXXXXXXXXXXXXX XX  XX
XXXXXXXXXXXXXXXX    XXX
XXXXXXXXXXXXXXXXXX  XXX
XXXXXXXXXXXXXXX XX XXXX