XXXXXXXXXXXXX
X  DXX    XXX
X XXXX    XXX
XXXXXX X   XX
XXXXXX Xp  XX
XXXXXX X  XXX
XXXXXX X  XXX
XXXXXX X   XX
XXXXX  XXXXXX
XXXXX XXXXXXX
XXXXX XXXXXXX
XXXXX XXXXXXX
XXXXXXXXXXXXX