XXXXXXXXXX
XXXXXX XXX
XXXXXX XXX
XXXXXX    
XXXXX     
XXXXX  X  
XXXXX     
XXXXX     
XXXXX  XX 
XXXXX DXX 