XXXXXXXXXXXXX
XXXX  D   XXD
XXXXX  X  XX 
X  XXp  XXXX 
XX XX X XXXX 
XXXXX    X   
XXXXXX     XX
XXXXXX XX  XX
XXXXXX    XX 
XXXXXXX XXXXX
XXXXXXX XXXXX
XXXXXXXXXXXXX
XXXXXXXXXXXXX