XXXXXXXXXX
XXXXXX  XX
XXp     XX
XX  XXX XX
XXXXXX  XX
XXXXXX  XX
XXXXXXXXXX
XXXXXXXXXX
XXXXXXXXXX
XXXXXXXXXX