XXXXXXXXXXXXXXXXXX
XXXXXXXXXXXXXXXXXX
XXXXXXXXXXXXXXXXXX
XXXXXXXXXXXXXXXXXX
XX  XXXXXXXXXXXXXX
XX  XXXXXXXXXXXXXX
XX      XXXXXXXXXX
XX  XXX XXXXXXXXXX
XXX X    XXXXXXXXX
XXX      X     XXX
X        X     XXX
X     XXXXXX XXXXX
X            XXXXX
X           XXXXXX
XX   XX     XXXXXX
XXXXXXX     XXXXXX
XXXXXXXXXXXXXXXXXX
XXXXXXXXXXXXXXXXXX