XXXXXXXXXXXXXXXDXXX XX
XXXXXXXXX  X  XXXXX   
   XXX p   p  XX      
XX      X     XX      
XXXX XXD   X      X XX
XXXX   p XXXXX X XXXXX
XXXXXX         XXXXXXX
XXXXXXXXXX  XXXXXXXXXX
XXXXXXXXXXXXXXXXXXXX  
XXXXXXXXX XXXXX      X
XXXX      X  X       X
XXXXXXXXX       XXXXX 
XXXXXXXXXXXXX   XXX   
XXXXXXXXXXXXXXX    p  
XXXXXXXXXXXXXXX XXXX X
XXXXXXXXXXXXXXXXXXXX X
XXXXXXXXXXXXXXXXXXXXXX
XXXXXXXXXXXXXXXXXXXXXX
XXXXXXXXXXXXXXXXXXXXXX
XXXXXXXXXXXXXXXXXXXXXX
XXXXXXXXXXXXXXXXXXXXXX
XXXXXXXXXXXXXXXXXXXXXX