 XXXXXX 
XXD XXXp
XXX XXX 
XXX  XXX
XXX  XXX
XX   XXX
XX   XXX
XXXXXXXX