XXXXXXXXXXXXXXXXXXXXXXXX
XXXXXXXXXXXXXXXXXXXXXXXX
XXXXXXXXXXXXXXXXXXXXXXXX
XXXXXXXXXXXXXXXXXXXXXXXX
XXXXXXXXXXXXXXXXXXXXXXXX
XX  XXXXXX  XXXXXXXXXXXX
XX     XXX  XXXXXXXXXXXX
XX  X                XXX
XXX X  XXX  D    XXX XXX
XXX X  XXX  XXXX XXX XXX
XX  p   XX  XXXX XXX XXX
X       XXX XXXX XXX XXX
Xp    p     XXXXDXXX XXX
X           XX    XX XXX
X           XX    XX XXX
X           XX    X   XX
XX                    XX
XX        XXXXXXXXXXXXXX
XXX       X   XXXXXXXXXX
XXXX      X p XXXXXXXXXX
XXXX     p    XXXXXXXXXX
XXXX    XXX   XXXXXXXXXX
XXXXXXXXXXXXXXXXXXXXXXXX
XXXXXXXXXXXXXXXXXXXXXXXX