XXXXXXXXXXXX
XX XX     XX
XX XX D XXXX
 X p  X   XX
XXXXX X   XX
XXXXX X   XX
X         XX
XXX XX    XX
XXX XXX   XX
X    XX  XXX
XXX XXD XXXX
XXX XXXXXXXX