XXXXXXXXXX
XXX    XXX
XXXX    XX
XXXD XXXXX
XXXX  XXXX
XXXX DXXXX
XXXX  X XX
XXX   X XX
X       XX
X  DXX XX 