XXXXXXXXXXXXXXXXXXX
XXXXXXXXXXXXXXXXXXX
XXXXXXXXXXXXXXXXXXX
XXXXXXXXXXXXXXXXXXX
XXX   XXXXXXXXXXXXX
XXX   X     XXXXXXX
XXX         XXXXXXX
XX          XXXXXXX
XX X X      XXXXXXX
XX X X      XXXXXXX
XX   X XX XXXXXXXXX
XX        XX   XXXX
X  X  p   XX   XXXX
X  X X         XXXX
X  X   XXXXX   XXXX
XXXX           XXXX
XXXX p   XXXXXXXXXX
XXXXXXXXXXXXXXXXXXX
XXXXXXXXXXXXXXXXXXX