XXXXXXXXXXXX
X   XXX  XXX
X        XXX
XX X XX  XXX
XXD   XXXXXX
XX    XXXXXX
XXD   XXXXXX
X        XXX
X        XXX
X        XXX
XXXXXXXXXXXX
XXXXXXXXXXXX