XXXXXXXXXXXXXXXXXXXXX
XXXXXXXXXXXXXXXXXXXXX
XXXXXXXXXXXXXXXXXXXXX
XXXXXXXXXXXXXXXXXXXXX
XX     XXXXXXXXXXXXXX
XX     XXXXXXXXXXXXXX
XXXX XXXXXXXXXXXXXXXX
XXXX XXXX    XXXXXXXX
XXXX XXXX    XXXXXXXX
XX    D      XXXXXXXX
XX   XXXX    XXXXXXXX
XX          pXXXXXXXX
XX      XXX DXXXXXXXX
XXp     XXX  XXXXXXXX
XX             XXXXXX
XX             XXXXXX
XXX        XXX   XXXX
XX        D   p  XXXX
XX       XXXXXXXXXXXX
XXXXXXXXXXXXXXXXXXXXX
XXXXXXXXXXXXXXXXXXXXX