XXXXXXXXXXXXX
XXXXXXXXXXXXX
XXXXX pX  XXX
XXXX   D  XXX
XXXXDp XX XXX
XXX p  XX XXX
XXX   X   XXX
XXX   X  XXXX
XX    XX XXXX
XX      XXXXX
XXXX    XXXXX
XXXXXXXXXXXXX
XXXXXXXXXXXXX