XXXXXXXXXXXX
XXXXXp XXXXX
XXXXX  XXXXX
XXXXX  XXXXX
X   XX XXXXX
X p     XXXX
XX XXX p XXX
XX XXX   XXX
XX       XXX
XX    XXXXXX
XXXXXXXXXXXX
XXXXXXXXXXXX