XXXXXXXX
X X  XXX
X X  XXX
X    XXX
    XXXX
XXX XXXX
XXX  XXX
XXXXXXXX