XXXXXXXXXXXXXXXXX
XXXXXXXXXXXXXXXXX
XXXXXXXXXXXXXXXXX
X    XXXXXXXXXXXX
X    XXXXXXXXXXXX
X    XXXXXXXXXXXX
XXX XXXXXXXXXXXXX
XXX     XXXXXXXXX
XXX         XXXXX
XXX XX XXX   XXXX
XXX X    D   XXXX
XXX     XX   XXXX
XXXXX   XXXXXXXXX
XXXXXXXXXXXXXXXXX
XXXXXXXXXXXXXXXXX
XXXXXXXXXXXXXXXXX
XXXXXXXXXXXXXXXXX