XXXXXXXXXXXXXXXXXXXX
XXXXXXXXXXXXXXX  XXX
XXXXXXXXXXXXXXX    X
XXXXXXXXXXXXXXXXX XX
XXXXXXXXXXXXXXXXX XX
XXXXXXXXXXXXX D   XX
XXXXXXXXXX XX XXXXXX
DXXXXXXXXXpXX XXXXXX
XXXXXXXXXX XX  XXXXX
XXXXXXXXXX XXX   XXX
XXXXXXXXX  XXXXX XX 
XXXXXXXXX XXXXX  XXX
XXXXXXXX   XXX   XXX
XXXXXXXX X X  p XXXX
XX XXXXX    X   XXXX
X   XXp    XXX   XXX
X X XX    XXXX   XXX
XX  XX   XXXXX X  XX
XX  XX    DXXX X  XX
XX     X  XXXX X   D