XXXXXXXXXXXXXXXX
XXXXX  XXXXXXXXX
XXXXX XXXXXXXXXX
XXXXX XXXXXXXX  
XXXX  XXXX  XX  
XXX  XXXXXX XXXX
XXXX XXXX   XXXX
XXXX  XXX XXXXXX
X X  XXXX  XXXXX
  XX XXXXX XXXXX
X XX XXXXXDXXXX 
X XX XXXX  X XXX
XXXX XXXX XX  XX
XXXX   XX   X  X
XXXXXX DX XXX  X
XXXX    X XXXpXX