XXXXXXXXXXXXXXXXXXXXXXXX
XXXXXXXXXXXXX  XXXXXXXXX
XXXXXXXXXXXXX  XXXXXXXXX
XXXXXXXXXXXXX  XXXXXXXXX
XXXXX  D       XXXXXXXXX
XXXX      XXX  XXXXXXXXX
X p p     XXX  XXXXXXXXX
X         D  X XXXXXXXXX
XX      X XX X XXXXXXXXX
X p     X    X XXXXXXXXX
X                  XXXXX
XX        X  X XXX XXXXX
XX        X  ppXXX XXXXX
XX             XXX XXXXX
X              XX   XXXX
X           p XXX   XXXX
XX          XXXXX   XXXX
XX                  XXXX
XX      p   XXXXX   XXXX
XX          D  XX   XXXX
XXp  XXX   XXp  X   XXXX
XXXXXXXXX       XXXXXXXX
XXXXXXXXXXXXXXXXXXXXXXXX
XXXXXXXXXXXXXXXXXXXXXXXX