XXXXXXXX
XXXXXXXX
XXXp XXX
XXX  XXX
X  p XXX
X   pXXX
XXXXXXXX
XXXXXXXX