XXXXXXXX
XXXXXXXX
X  XXXXX
X  X  XX
X     XX
X p  XXX
XXXXXXXX
XXXXXXXX