XXXXXXXXXXXXXXXXXXXXXXX
XXXXX     XXXXXXXXXXXXX
XXXXX     XXXXXXXXXXXXX
XXXXX     XXXXXXXXXXXXX
XXXXX     XXXXXXXXXXXXX
XXXXX     XXXXXXXXXXXXX
XXXXX X XXXXXXXXXXXXXXX
XXXXX X XXXXXXX  XXXXXX
XXXXX X XXXXXXX  XXXXXX
X  XX X XXXXXXX  XXXXXX
X       DD   XX  XXXXXX
X  XX X XXXX XX   XXXXX
XX      XXXX XX   XXXXX
XX      XXXX XX   XXXXX
XX      XX    XX XXXXXX
XX      X     XX XXXXXX
XX  XX          XXXXXXX
XX  XX  X p   XXXXXXXXX
X    XXXXX    XXXXXXXXX
X    XXXXXXXXXXXXXXXXXX
X  p XXXXXXXXXXXXXXXXXX
XXXXXXXXXXXXXXXXXXXXXXX
XXXXXXXXXXXXXXXXXXXXXXX