XXXXXXXXXXXXXXXXXXXX
XXXXX   D    XXXX  p
XXXXXX X      XX   X
XXXXXX  X          X
XXXXXX  X X XXX    X
XXXXX   XXX  XX    X
XXXXXXX XX   XX XX X
XXXXXXX X   XX DXX X
XXXXXXX    XXX  XXDX
XXXXXXX    XXX      
XXXXXXX   XXXX   XXX
XXXXXXX  XXXXXX XXXX
XXXXXX   XXXXXXXXXXX
XXXXX    DXXXXXXXXXX
XXXXX XXX XXXXXXXXXX
XXXXX XXX  XXXXXXXXX
XXXXX XXXXXXXXXXXXX 
XXXXX XXXXXXXXXXXXX 
XXXXX  XXXXXXXXXXXX 
XXXXXXXXXXXXXXXXXXX 