XXXXXXXXXXXXXXXXXXXXXXX
XXXXXXXXXXXXXXXXXXXXXXX
XXXXXXXXXXXXXXXXXXXXXXX
XX      XXXXXXXXXXXXXXX
XX      XXXXXXXXXXXXXXX
XX     XXXXXXXXXX   XXX
XX      D    XXXX   XXX
XX                  XXX
XXX X   Xp   XXXX   XXX
X p       XXXXXXX   XXX
X      XX XXXXXXXX XXXX
XX        XXXX     XXXX
XX     X  p XX     XXXX
XX    XX           XXXX
XX          XX     XXXX
XX          XX     XXXX
X           XX  p  XXXX
X      p   XX    XXXXXX
X                    XX
X       p            XX
XXXX            XXXXXXX
XXXXXXXXXXXXXXXXXXXXXXX
XXXXXXXXXXXXXXXXXXXXXXX