 D   XXX
XXXX  XX
XXXXp XX
XXX   XX
XXX  XXX
XXXXXXXX
XXXXXXXX
XXXXXXXX