XXXXXXXXXXXXXXXXXXXXX
X   XXXXXXXXXXXXXXXXX
X       XXXXXXXXXXXXX
X  XXXX XXXXXXXXXXXXX
X         XXXXXXXXXXX
XX      X XXXXXXXXXXX
XX     DX XXXX   XXXX
XXD         XX   XXXX
XX      X X XX   XXXX
XX    p X        XXXX
XX      X   XXp  XXXX
XX      X    X   XXXX
XX     pX    XX    XX
XX    X X    XX    XX
XX       p   XX p  XX
XX           XX    XX
XX              DXXXX
XXXXXXXXXXXXXXXXXXXXX
XXXXXXXXXXXXXXXXXXXXX
XXXXXXXXXXXXXXXXXXXXX
XXXXXXXXXXXXXXXXXXXXX