XXXXXXXXXXXXX
XXXX XXXXXXXX
XXXX XXXXX XX
XXXX  XXXX  X
XXXXX   X  XX
X XXXXX   XXX
X XXXXX    XX
XXXXXXXX   XX
XXXXXXXX  X  
XXXXX XX   X 
XXXXX  XX  XX
XXXXX  XX  XX
XXXXX  XX  XX