XXXXXXXXXXXXXXXXXXXXXX
XXX   XXXXXXXXXXXXXXXX
XXX   XXXXXXXXXXXXXXXX
XXX   XXXXXXXXXXXXXXXX
XXXX XXXX    XXXXXXXXX
XXXX XXXX    XXXXXXXXX
XX      X    XXXXXXXXX
XX      XXX XXXXXXXXXX
XXXX  DXXXX XXXXXXXXXX
XXX      XX XXXXXXXXXX
XXX             XXXXXX
XXX         XXX X   XX
XXX                 XX
XXX        XXXX X   XX
XXX         XXX XX XXX
X           XX  XX XXX
X      X    XX    XXXX
X           XX  XXXXXX
XX       DXXXXXXXXXXXX
XXX  pXXXXXXXXXXXXXXXX
XXXXXXXXXXXXXXXXXXXXXX
XXXXXXXXXXXXXXXXXXXXXX