XXXXXXXXXXXXXXXXX
XXXXXXXXXXXXXXXXX
XXXX  XXXXXXXXXXX
XXXX  XXXXXXXXXXX
XXXX  XXXXXXXXXXX
XXXX  XX  XXXXXXX
XX    XX  XXXXXXX
XX p      XXXXXXX
X         X    XX
X           p  XX
X         X    XX
X          X  XXX
XXXp  X       XXX
XXX      pX   XXX
XXXXXXXXXXX   XXX
XXXXXXXXXXXXXXXXX
XXXXXXXXXXXXXXXXX