XXXXXXXXXXXXXX
X   XXXXXXXXXX
X   XXXXXXXXXX
XX  XXXXXXXXXX
X   XXXXXXXXXX
X   X  XXXXXXX
X   X  XXXXXXX
XXX X  XXXXXXX
XXX XX XXXXXXX
XX  XX XXXXXXX
XX    XXXXXXXX
XXXXXXXXXXXXXX
XXXXXXXXXXXXXX
XXXXXXXXXXXXXX