XXXXXXXXXXXXXXXXX
XXXXXXXXXXXXXXXXX
XXXXXXXXXXXXXXXXX
XXX   X    XXXXXX
XXX p      XXXXXX
XXX   XXXXXXXXXXX
XXXX XXXXXXXXXXXX
XXXX XXXXX    XXX
XXXX XXXXX p  XXX
XXXX     D    XXX
XXXXXXXXXX   pXXX
X  XXXXXXXXX XXXX
X  XXXXXXXXX XXXX
Xp     D       XX
X  XXXXXXXXX   XX
XXXXXXXXXXXXXXXXX
XXXXXXXXXXXXXXXXX