XXXXXXXXXXXXXXXXXXXXXXX
XXXXXXXXXXXXXXXXXXXXXXX
XXXXXXXXXXXXXXXXXXXXXXX
XXXXXXXXXXXXXXXXXXXXXXX
XXXXXXXXXXXXXXXX   XXXX
XXXXXXXXXXXXXXXX   XXXX
XX          XXXX   XXXX
XX                 XXXX
XX     XX XXXXXXD XXXXX
XXX  XXXXDXXXXXX  XXXXX
XXX        XXXXXD XXXXX
X  p        XXXX  XXXXX
Xp          XXXX  XXXXX
XX          XXX   XXXXX
XX   XXX    XXX   XXXXX
X    XXX    XXX  XXXXXX
X    XXX  X  XX  XXXXXX
XX XXXXX  X  XX  XXXXXX
XX           XXXXXXXXXX
XXXXXXXXXXX  XXXXXXXXXX
XXXXXXXXXXX  XXXXXXXXXX
XXXXXXXXXXXXXXXXXXXXXXX
XXXXXXXXXXXXXXXXXXXXXXX