XXXXXXXXXXXXXXXXXXXXX
XXXXXXXXXXXXXXXXXXXXX
XXXXXXXXXXXXXXXXXXXXX
XXXXXXXXXXXXXXXXXXXXX
XXX    pXXXXXXXXXXXXX
XXX     DXXXXXXXXXXXX
XXX      XXXXXXXXXXXX
X        XXXXXXXXXXXX
X      pD     XXXXXXX
X          XX XXXXXXX
X          XX XXXXXXX
X          XX   XXXXX
X           X   XXXXX
X     p   p       XXX
X     X         X XXX
X p    XX   X   XDXXX
XX p       X   XppXXX
XX                XXX
XXXXXXXXXX        XXX
XXXXXXXXXXXXXXXXXXXXX
XXXXXXXXXXXXXXXXXXXXX