XXXXXXXXXXXXXXXX
X   XXXXXXXXXXXX
X          XXXXX
XX XXXXXXX XXXXX
XX XXXXXXX XXXXX
X   XXXXXX XXXXX
X        X XXXXX
XX        DXXXXX
X          XXXXX
X      XXX XXXXX
X        X XXXXX
X  p  XX    XXXX
X           XXXX
XXXX        XXXX
XXXXXXXXXXXXXXXX
XXXXXXXXXXXXXXXX