XXXXXXXXXXXXXXXX
X  pXXXXXXXXXXXX
X           DXXX
XX XXXXXXXXX XXX
X   XXXXXXXX XXX
X   XXX  Xp   XX
XX  XXX       XX
XX    D  X    XX
XX    X  XX   XX
XX     XXXX   XX
XX         p  XX
XX     XXXXp  XX
XXX    XXXXX XXX
XXX        DXXXX
XXXXXXXXXXXXXXXX
XXXXXXXXXXXXXXXX